//MAP CONVERTED BY dmm2tgm.py THIS HEADER COMMENT PREVENTS RECONVERSION, DO NOT REMOVE
"aa" = (
/turf/closed/mineral/volcanic/lava_land_surface,
/area/lavaland/surface/outdoors)
"ab" = (
/turf/open/floor/plating/asteroid/basalt/lava_land_surface,
/area/lavaland/surface/outdoors)
"ac" = (
/turf/closed/wall/r_wall,
/area/ruin/powered/seedvault)
"ad" = (
/obj/machinery/vending/hydronutrients,
/obj/effect/turf_decal/trimline/green/filled/line,
/turf/open/floor/plasteel/dark,
/area/ruin/powered/seedvault)
"ae" = (
/obj/machinery/smartfridge,
/obj/effect/turf_decal/trimline/green/filled/line,
/turf/open/floor/plasteel/dark,
/area/ruin/powered/seedvault)
"af" = (
/obj/machinery/vending/hydroseeds,
/obj/effect/turf_decal/trimline/green/filled/line,
/turf/open/floor/plasteel/dark,
/area/ruin/powered/seedvault)
"ag" = (
/obj/item/storage/toolbox/syndicate,
/obj/structure/table/wood,
/obj/effect/turf_decal/trimline/green/filled/line,
/turf/open/floor/plasteel/dark,
/area/ruin/powered/seedvault)
"ah" = (
/turf/open/floor/plasteel/freezer,
/area/ruin/powered/seedvault)
"ai" = (
/obj/item/reagent_containers/glass/beaker/bluespace,
/obj/item/reagent_containers/glass/beaker/bluespace,
/obj/item/reagent_containers/glass/beaker/bluespace,
/obj/item/reagent_containers/glass/beaker/bluespace,
/obj/structure/table/wood,
/obj/effect/turf_decal/trimline/green/filled/line,
/turf/open/floor/plasteel/dark,
/area/ruin/powered/seedvault)
"aj" = (
/obj/structure/table/wood,
/obj/item/gun/energy/floragun,
/obj/item/gun/energy/floragun,
/obj/item/gun/energy/floragun,
/obj/item/gun/energy/floragun,
/obj/effect/decal/cleanable/cobweb/cobweb2,
/obj/effect/turf_decal/trimline/green/filled/line,
/turf/open/floor/plasteel/dark,
/area/ruin/powered/seedvault)
"ak" = (
/obj/effect/mob_spawn/human/seed_vault,
/obj/machinery/light{
	dir = 1
	},
/turf/open/floor/plasteel/freezer,
/area/ruin/powered/seedvault)
"al" = (
/turf/open/floor/plasteel/dark,
/area/ruin/powered/seedvault)
"am" = (
/obj/machinery/light{
	dir = 4
	},
/turf/open/floor/plasteel/dark,
/area/ruin/powered/seedvault)
"an" = (
/obj/machinery/light{
	dir = 8
	},
/turf/open/floor/plasteel/dark,
/area/ruin/powered/seedvault)
"ao" = (
/obj/structure/loom,
/turf/open/floor/plasteel/dark,
/area/ruin/powered/seedvault)
"ap" = (
/obj/machinery/light{
	dir = 1
	},
/obj/effect/mob_spawn/human/seed_vault,
/turf/open/floor/plasteel/freezer,
/area/ruin/powered/seedvault)
"aq" = (
/obj/machinery/light{
	dir = 1
	},
/obj/effect/mob_spawn/human/seed_vault,
/obj/effect/decal/cleanable/cobweb/cobweb2,
/turf/open/floor/plasteel/freezer,
/area/ruin/powered/seedvault)
"ar" = (
/obj/structure/closet/crate/hydroponics,
/obj/item/clothing/under/rank/civilian/hydroponics,
/obj/item/clothing/under/rank/civilian/hydroponics,
/obj/item/clothing/under/rank/civilian/hydroponics,
/obj/item/clothing/under/rank/civilian/hydroponics,
/obj/effect/decal/cleanable/cobweb,
/obj/effect/turf_decal/trimline/green/filled/line{
	dir = 4
	},
/turf/open/floor/plasteel/dark,
/area/ruin/powered/seedvault)
"as" = (
/obj/machinery/door/airlock/glass_large,
/turf/open/floor/plasteel/freezer,
/area/ruin/powered/seedvault)
"at" = (
/obj/structure/closet/crate/hydroponics,
/obj/item/cultivator,
/obj/item/cultivator,
/obj/item/cultivator,
/obj/item/cultivator,
/obj/item/shovel/spade,
/obj/item/shovel/spade,
/obj/item/shovel/spade,
/obj/item/shovel/spade,
/obj/item/hatchet,
/obj/item/hatchet,
/obj/item/hatchet,
/obj/item/hatchet,
/obj/effect/turf_decal/trimline/green/filled/line{
	dir = 4
	},
/turf/open/floor/plasteel/dark,
/area/ruin/powered/seedvault)
"au" = (
/obj/machinery/door/airlock/titanium,
/turf/open/floor/vault,
/area/ruin/powered/seedvault)
"av" = (
/obj/machinery/door/airlock/external,
/obj/effect/mapping_helpers/airlock/cyclelink_helper,
/turf/open/floor/plasteel/dark,
/area/ruin/powered/seedvault)
"aw" = (
/obj/machinery/reagentgrinder{
	pixel_y = 5
	},
/obj/structure/table/glass,
/obj/effect/turf_decal/trimline/green/filled/end,
/obj/machinery/airalarm/directional/north,
/turf/open/floor/plasteel/dark,
/area/ruin/powered/seedvault)
"ax" = (
/obj/structure/reagent_dispensers/watertank/high,
/obj/effect/turf_decal/trimline/green/line{
	dir = 9
	},
/obj/effect/turf_decal/trimline/green/filled/corner,
/turf/open/floor/plasteel/dark,
/area/ruin/powered/seedvault)
"ay" = (
/obj/structure/reagent_dispensers/watertank/high,
/obj/effect/turf_decal/trimline/green/line{
	dir = 5
	},
/obj/effect/turf_decal/trimline/green/filled/corner{
	dir = 8
	},
/turf/open/floor/plasteel/dark,
/area/ruin/powered/seedvault)
"az" = (
/obj/structure/closet/crate/hydroponics,
/obj/item/soap/homemade,
/obj/item/soap/homemade,
/obj/effect/turf_decal/trimline/green/filled/line{
	dir = 6
	},
/turf/open/floor/plasteel/dark,
/area/ruin/powered/seedvault)
"aA" = (
/turf/open/floor/vault,
/area/ruin/powered/seedvault)
"aB" = (
/obj/effect/spawner/lootdrop/seed_vault,
/obj/structure/closet/crate/hydroponics,
/obj/effect/spawner/lootdrop/seed_vault,
/obj/effect/spawner/lootdrop/seed_vault,
/obj/item/vending_refill/hydronutrients,
/obj/item/vending_refill/hydroseeds,
/turf/open/floor/vault,
/area/ruin/powered/seedvault)
"aC" = (
/obj/structure/sink{
	dir = 4;
	pixel_x = -12;
	pixel_y = 2
	},
/obj/machinery/light,
/turf/open/floor/plasteel/dark,
/area/ruin/powered/seedvault)
"aD" = (
/obj/structure/sink{
	dir = 8;
	pixel_x = 11
	},
/obj/machinery/light,
/turf/open/floor/plasteel/dark,
/area/ruin/powered/seedvault)
"aE" = (
/obj/structure/closet/crate/hydroponics,
/obj/structure/beebox,
/obj/item/melee/flyswatter,
/obj/item/honey_frame,
/obj/item/honey_frame,
/obj/item/honey_frame,
/obj/item/queen_bee/bought,
/obj/item/clothing/head/beekeeper_head,
/obj/item/clothing/suit/beekeeper_suit,
/obj/machinery/light{
	dir = 8
	},
/turf/open/floor/vault,
/area/ruin/powered/seedvault)
"aF" = (
/obj/structure/table/wood,
/obj/item/lighter,
/obj/item/lighter,
/obj/item/storage/fancy/rollingpapers,
/obj/item/storage/fancy/rollingpapers,
/obj/item/storage/fancy/rollingpapers,
/obj/item/storage/fancy/rollingpapers,
/turf/open/floor/plasteel/dark,
/area/ruin/powered/seedvault)
"aG" = (
/turf/closed/mineral/volcanic/lava_land_surface,
/area/ruin/powered/seedvault)
"aH" = (
/obj/machinery/door/airlock/vault,
/obj/machinery/atmospherics/pipe/simple/supply/hidden,
/turf/open/floor/plasteel/freezer,
/area/ruin/powered/seedvault)
"aI" = (
/obj/machinery/light{
	dir = 1
	},
/turf/open/floor/vault,
/area/ruin/powered/seedvault)
"aJ" = (
/obj/structure/reagent_dispensers/watertank/high,
/obj/effect/turf_decal/trimline/green/line{
	dir = 10
	},
/obj/effect/turf_decal/trimline/green/filled/corner{
	dir = 4
	},
/turf/open/floor/plasteel/dark,
/area/ruin/powered/seedvault)
"aK" = (
/obj/structure/sink{
	dir = 8;
	pixel_x = 11
	},
/obj/machinery/light{
	dir = 1
	},
/turf/open/floor/plasteel/dark,
/area/ruin/powered/seedvault)
"aL" = (
/obj/structure/table/wood,
/obj/item/storage/box/disks_plantgene,
/obj/item/storage/box/disks_plantgene,
/obj/item/storage/box/disks_plantgene,
/turf/open/floor/vault,
/area/ruin/powered/seedvault)
"aM" = (
/obj/structure/table/wood,
/obj/machinery/smartfridge/disks{
	pixel_y = 2
	},
/turf/open/floor/vault,
/area/ruin/powered/seedvault)
"aN" = (
/turf/open/floor/mineral/titanium/blue,
/area/ruin/powered/seedvault)
"aO" = (
/obj/machinery/light{
	dir = 4
	},
/obj/structure/reagent_dispensers/watertank/high,
/obj/effect/turf_decal/trimline/green/line{
	dir = 6
	},
/obj/effect/turf_decal/trimline/green/filled/corner{
	dir = 1
	},
/turf/open/floor/plasteel/dark,
/area/ruin/powered/seedvault)
"aP" = (
/obj/machinery/plantgenes/seedvault{
	pixel_y = 6
	},
/obj/structure/table/wood,
/turf/open/floor/vault,
/area/ruin/powered/seedvault)
"aQ" = (
/obj/effect/decal/cleanable/dirt,
/turf/open/floor/plasteel/freezer,
/area/ruin/powered/seedvault)
"aR" = (
/obj/machinery/door/airlock/vault,
/obj/effect/mapping_helpers/airlock/cyclelink_helper{
	dir = 1
	},
/turf/open/floor/plasteel/dark,
/area/ruin/powered/seedvault)
"aS" = (
/obj/structure/table/wood,
/obj/item/storage/bag/plants,
/obj/item/storage/bag/plants,
/obj/item/storage/bag/plants,
/obj/item/storage/bag/plants,
/obj/effect/turf_decal/trimline/green/filled/line{
	dir = 1
	},
/turf/open/floor/plasteel/dark,
/area/ruin/powered/seedvault)
"aT" = (
/obj/item/reagent_containers/glass/bucket,
/obj/structure/table/wood,
/obj/item/reagent_containers/glass/bucket,
/obj/item/reagent_containers/glass/bucket,
/obj/item/reagent_containers/glass/bucket,
/obj/effect/turf_decal/trimline/green/filled/line{
	dir = 5
	},
/turf/open/floor/plasteel/dark,
/area/ruin/powered/seedvault)
"aU" = (
/obj/machinery/light,
/turf/open/floor/plasteel/freezer,
/area/ruin/powered/seedvault)
"aV" = (
/obj/effect/turf_decal/trimline/green/line,
/obj/effect/turf_decal/trimline/green/line{
	dir = 1
	},
/obj/structure/table/reinforced,
/turf/open/floor/mineral/plastitanium,
/area/ruin/powered/seedvault)
"aW" = (
/obj/machinery/disposal/bin,
/obj/structure/disposalpipe/trunk{
	dir = 4
	},
/turf/open/floor/mineral/titanium/blue,
/area/ruin/powered/seedvault)
"aX" = (
/obj/structure/closet/crate/hydroponics,
/obj/structure/beebox,
/obj/item/melee/flyswatter,
/obj/item/honey_frame,
/obj/item/honey_frame,
/obj/item/honey_frame,
/obj/item/queen_bee/bought,
/obj/item/clothing/head/beekeeper_head,
/obj/item/clothing/suit/beekeeper_suit,
/obj/effect/decal/cleanable/cobweb,
/turf/open/floor/vault,
/area/ruin/powered/seedvault)
"aY" = (
/obj/effect/decal/cleanable/food/plant_smudge,
/obj/machinery/atmospherics/components/unary/vent_pump/on{
	dir = 1
	},
/turf/open/floor/vault,
/area/ruin/powered/seedvault)
"aZ" = (
/obj/structure/sink{
	dir = 4;
	pixel_x = -12;
	pixel_y = 2
	},
/obj/machinery/light{
	dir = 1
	},
/obj/effect/decal/cleanable/cobweb,
/turf/open/floor/plasteel/dark,
/area/ruin/powered/seedvault)
"ba" = (
/obj/effect/turf_decal/trimline/green/line{
	dir = 4
	},
/obj/effect/turf_decal/trimline/green/line{
	dir = 8
	},
/obj/structure/table/reinforced,
/turf/open/floor/mineral/plastitanium,
/area/ruin/powered/seedvault)
"bb" = (
/obj/effect/decal/cleanable/dirt,
/turf/open/floor/mineral/titanium/blue,
/area/ruin/powered/seedvault)
"bc" = (
/obj/machinery/light{
	dir = 8
	},
/obj/machinery/hydroponics/constructable,
/obj/effect/decal/cleanable/dirt,
/obj/effect/turf_decal/trimline/green/line{
	dir = 8
	},
/obj/effect/turf_decal/trimline/green/line{
	dir = 4
	},
/turf/open/floor/mineral/plastitanium,
/area/ruin/powered/seedvault)
"bd" = (
/obj/machinery/chem_dispenser/mutagensaltpeter,
/obj/effect/turf_decal/trimline/green/corner,
/obj/effect/turf_decal/trimline/green/line{
	dir = 9
	},
/turf/open/floor/mineral/plastitanium,
/area/ruin/powered/seedvault)
"be" = (
/obj/effect/turf_decal/trimline/green/line,
/obj/effect/turf_decal/trimline/green/line{
	dir = 1
	},
/turf/open/floor/mineral/plastitanium,
/area/ruin/powered/seedvault)
"bf" = (
/obj/machinery/biogenerator,
/obj/effect/decal/cleanable/dirt,
/obj/effect/turf_decal/trimline/green/corner{
	dir = 8
	},
/obj/effect/turf_decal/trimline/green/line{
	dir = 5
	},
/turf/open/floor/mineral/plastitanium,
/area/ruin/powered/seedvault)
"bg" = (
/obj/machinery/light{
	dir = 4
	},
/obj/machinery/hydroponics/constructable,
/obj/effect/decal/cleanable/dirt,
/obj/effect/decal/cleanable/cobweb/cobweb2,
/obj/effect/turf_decal/trimline/green/line{
	dir = 8
	},
/obj/effect/turf_decal/trimline/green/line{
	dir = 4
	},
/turf/open/floor/mineral/plastitanium,
/area/ruin/powered/seedvault)
"bh" = (
/obj/machinery/hydroponics/constructable,
/obj/effect/turf_decal/trimline/green/line{
	dir = 6
	},
/turf/open/floor/mineral/plastitanium,
/area/ruin/powered/seedvault)
"bi" = (
/obj/structure/disposalpipe/segment{
	dir = 4
	},
/obj/effect/turf_decal/trimline/green/line{
	dir = 4
	},
/obj/effect/turf_decal/trimline/green/line{
	dir = 8
	},
/obj/structure/table/reinforced,
/turf/open/floor/mineral/plastitanium,
/area/ruin/powered/seedvault)
"bj" = (
/obj/machinery/hydroponics/constructable,
/obj/effect/turf_decal/trimline/green/line{
	dir = 10
	},
/turf/open/floor/mineral/plastitanium,
/area/ruin/powered/seedvault)
"bk" = (
/obj/structure/disposalpipe/segment{
	dir = 4
	},
/obj/effect/decal/cleanable/dirt,
/turf/open/floor/mineral/titanium/blue,
/area/ruin/powered/seedvault)
"bl" = (
/obj/machinery/light{
	dir = 4
	},
/obj/structure/disposalpipe/segment{
	dir = 4
	},
/obj/machinery/hydroponics/constructable,
/obj/effect/decal/cleanable/dirt,
/obj/effect/turf_decal/trimline/green/line{
	dir = 8
	},
/obj/effect/turf_decal/trimline/green/line{
	dir = 4
	},
/turf/open/floor/mineral/plastitanium,
/area/ruin/powered/seedvault)
"bm" = (
/obj/structure/disposalpipe/trunk{
	dir = 8
	},
/obj/structure/flora/ausbushes/fullgrass,
/obj/structure/disposaloutlet,
/obj/structure/flora/ausbushes/fullgrass,
/obj/machinery/light{
	dir = 1
	},
/turf/open/floor/plating/grass/lavaland,
/area/ruin/powered/seedvault)
"bn" = (
/obj/structure/window/spawner/east,
/obj/structure/flora/ausbushes/palebush,
/obj/structure/flora/ausbushes/ppflowers,
/turf/open/floor/plating/grass/lavaland,
/area/ruin/powered/seedvault)
"bo" = (
/obj/machinery/chem_master/condimaster,
/obj/effect/turf_decal/trimline/green/corner{
	dir = 4
	},
/obj/effect/turf_decal/trimline/green/line{
	dir = 10
	},
/turf/open/floor/mineral/plastitanium,
/area/ruin/powered/seedvault)
"bp" = (
/obj/machinery/seed_extractor,
/obj/effect/turf_decal/trimline/green/corner{
	dir = 1
	},
/obj/effect/turf_decal/trimline/green/line{
	dir = 6
	},
/turf/open/floor/mineral/plastitanium,
/area/ruin/powered/seedvault)
"bq" = (
/obj/machinery/light{
	dir = 4
	},
/obj/machinery/hydroponics/constructable,
/obj/effect/decal/cleanable/dirt,
/obj/effect/turf_decal/trimline/green/line{
	dir = 8
	},
/obj/effect/turf_decal/trimline/green/line{
	dir = 4
	},
/turf/open/floor/mineral/plastitanium,
/area/ruin/powered/seedvault)
"br" = (
/obj/structure/flora/ausbushes/sunnybush,
/obj/structure/flora/grass/jungle/b,
/turf/open/floor/plating/grass/lavaland,
/area/ruin/powered/seedvault)
"bs" = (
/obj/structure/window/spawner/east,
/obj/structure/flora/ausbushes/sparsegrass,
/turf/open/floor/plating/grass/lavaland,
/area/ruin/powered/seedvault)
"bt" = (
/obj/structure/window/spawner,
/obj/structure/flora/ausbushes/ppflowers,
/obj/structure/flora/ausbushes/genericbush,
/obj/structure/flora/ausbushes/brflowers,
/turf/open/floor/plating/grass/lavaland,
/area/ruin/powered/seedvault)
"bu" = (
/obj/structure/window/spawner/east,
/obj/structure/flora/ausbushes/fernybush,
/obj/structure/flora/ausbushes/ywflowers,
/obj/structure/flora/ausbushes/sparsegrass,
/obj/effect/decal/cleanable/glass,
/turf/open/floor/plating/grass/lavaland,
/area/ruin/powered/seedvault)
"bv" = (
/obj/machinery/light,
/obj/machinery/hydroponics/constructable,
/obj/effect/decal/cleanable/dirt,
/obj/effect/turf_decal/trimline/green/line{
	dir = 1
	},
/obj/effect/turf_decal/trimline/green/line,
/turf/open/floor/mineral/plastitanium,
/area/ruin/powered/seedvault)
"bw" = (
/obj/machinery/light,
/obj/machinery/hydroponics/constructable,
/obj/effect/decal/cleanable/dirt,
/obj/effect/decal/cleanable/dirt,
/obj/effect/turf_decal/trimline/green/line{
	dir = 1
	},
/obj/effect/turf_decal/trimline/green/line,
/turf/open/floor/mineral/plastitanium,
/area/ruin/powered/seedvault)
"bx" = (
/obj/effect/decal/cleanable/glass,
/turf/open/floor/plating/asteroid/basalt/lava_land_surface,
/area/lavaland/surface/outdoors)
"by" = (
/obj/structure/disposalpipe/segment{
	dir = 6
	},
/turf/closed/wall/r_wall,
/area/ruin/powered/seedvault)
"bz" = (
/obj/structure/disposalpipe/segment{
	dir = 4
	},
/turf/open/floor/mineral/titanium/blue,
/area/ruin/powered/seedvault)
"bA" = (
/obj/structure/disposalpipe/segment{
	dir = 9
	},
/turf/closed/wall/r_wall,
/area/ruin/powered/seedvault)
"bB" = (
/obj/machinery/hydroponics/constructable,
/obj/effect/turf_decal/trimline/green/line{
	dir = 5
	},
/turf/open/floor/mineral/plastitanium,
/area/ruin/powered/seedvault)
"bC" = (
/obj/machinery/hydroponics/constructable,
/obj/effect/turf_decal/trimline/green/line{
	dir = 9
	},
/turf/open/floor/mineral/plastitanium,
/area/ruin/powered/seedvault)
"bD" = (
/turf/closed/wall/r_wall,
/area/lavaland/surface/outdoors)
"ca" = (
/obj/machinery/atmospherics/components/unary/tank/air{
	dir = 4
	},
/turf/open/floor/plasteel/freezer,
/area/ruin/powered/seedvault)
"oR" = (
/obj/machinery/atmospherics/pipe/simple/supply/hidden{
	dir = 10
	},
/turf/open/floor/plasteel/freezer,
/area/ruin/powered/seedvault)
"pW" = (
/obj/machinery/atmospherics/pipe/manifold4w/supply/hidden,
/turf/open/floor/plasteel/freezer,
/area/ruin/powered/seedvault)
"qQ" = (
/obj/machinery/atmospherics/pipe/manifold/supply/hidden,
/turf/open/floor/plasteel/freezer,
/area/ruin/powered/seedvault)
"sv" = (
/obj/machinery/atmospherics/pipe/simple/supply/hidden,
/turf/open/floor/vault,
/area/ruin/powered/seedvault)
"Bb" = (
/obj/machinery/atmospherics/pipe/simple/supply/hidden,
/turf/open/floor/plasteel/freezer,
/area/ruin/powered/seedvault)
"DA" = (
/obj/effect/decal/cleanable/dirt,
/obj/machinery/atmospherics/pipe/simple/supply/hidden,
/turf/open/floor/mineral/titanium/blue,
/area/ruin/powered/seedvault)
"Eu" = (
/obj/machinery/light,
/obj/machinery/atmospherics/pipe/simple/supply/hidden{
	dir = 4
	},
/turf/open/floor/plasteel/freezer,
/area/ruin/powered/seedvault)
"KF" = (
/obj/machinery/door/airlock/titanium,
/obj/machinery/atmospherics/pipe/simple/supply/hidden,
/turf/open/floor/vault,
/area/ruin/powered/seedvault)
"PH" = (
/obj/machinery/atmospherics/pipe/simple/supply/hidden{
	dir = 4
	},
/turf/open/floor/plasteel/freezer,
/area/ruin/powered/seedvault)
"Uz" = (
/obj/machinery/atmospherics/components/unary/vent_pump/on{
	dir = 1
	},
/turf/open/floor/mineral/titanium/blue,
/area/ruin/powered/seedvault)
"Vn" = (
/obj/machinery/atmospherics/components/unary/vent_pump/on,
/turf/open/floor/plasteel/freezer,
/area/ruin/powered/seedvault)

(1,1,1) = {"
aa
aa
aa
aa
aa
aa
aa
aa
aa
aa
aa
aa
aa
aa
aa
aa
aa
aa
ab
ab
"}
(2,1,1) = {"
aa
aa
aa
aa
ab
ab
aa
aa
aa
aa
aa
aa
ab
aa
aa
aa
aa
aa
aa
ab
"}
(3,1,1) = {"
aa
ac
ac
ac
ac
ac
ac
aa
aa
aa
aa
ab
ab
ab
aa
aa
aa
ab
ab
ab
"}
(4,1,1) = {"
aa
ac
ak
ah
ac
ca
ac
ac
ac
ac
ab
ab
ab
ab
ab
ab
ab
ab
aa
aa
"}
(5,1,1) = {"
aa
ac
ap
ah
as
PH
aQ
av
al
aR
ab
ab
ab
ab
ab
aa
aa
aa
aa
aa
"}
(6,1,1) = {"
aa
ac
ap
Vn
Bb
qQ
ah
av
am
aR
ab
ab
ac
ac
ac
ac
ac
aa
aa
aa
"}
(7,1,1) = {"
aa
ac
aq
ah
ac
PH
aU
ac
ac
ac
ac
ac
ac
bc
bc
bc
ac
ac
bD
aa
"}
(8,1,1) = {"
aa
ac
ac
ac
ac
PH
ah
aS
ac
aG
ac
bh
aN
aN
aN
aN
aN
bB
ac
aa
"}
(9,1,1) = {"
ac
ac
ar
at
az
PH
ah
aT
ac
ac
ac
bb
bb
aN
aN
aN
aN
aN
ac
ac
"}
(10,1,1) = {"
ac
ad
al
al
al
PH
ah
al
aC
ac
aZ
bb
aN
bd
ba
bo
aN
aN
bv
ac
"}
(11,1,1) = {"
ac
ae
al
Vn
Bb
pW
Bb
Bb
Bb
aH
Bb
DA
Uz
aV
aW
be
aN
aN
bw
ac
"}
(12,1,1) = {"
ac
af
am
al
al
PH
ah
al
aD
ac
aK
bb
aN
bf
bi
bp
aN
aN
bv
ac
"}
(13,1,1) = {"
ac
ac
ac
aw
al
PH
ah
aF
ac
ac
ac
aN
aN
aN
bz
aN
aN
aN
ac
ac
"}
(14,1,1) = {"
ac
ag
an
al
al
PH
ah
ah
au
aA
ac
bj
aN
bb
bk
aN
bb
bC
ac
aa
"}
(15,1,1) = {"
ac
ai
al
Vn
Bb
qQ
ah
aF
ac
aA
ac
ac
ac
bg
bl
bq
ac
ac
ac
aa
"}
(16,1,1) = {"
ac
aj
al
al
al
Eu
ac
ac
ac
aI
aA
aL
ac
by
bA
ac
ac
ab
ab
aa
"}
(17,1,1) = {"
ac
ac
ao
al
al
PH
ac
aX
aE
aA
aA
aP
ac
bm
br
bt
ab
ab
aa
aa
"}
(18,1,1) = {"
aa
ac
ac
ax
aJ
oR
KF
sv
sv
aY
aM
ac
ac
bn
bs
bu
bx
ab
ab
ab
"}
(19,1,1) = {"
aa
aa
ac
ay
aO
ah
ac
aB
aB
aB
ac
ac
aa
aa
aa
aa
ab
ab
ab
ab
"}
(20,1,1) = {"
aa
aa
ac
ac
ac
ac
ac
ac
ac
ac
ac
aa
aa
aa
aa
aa
aa
ab
ab
aa
"}
