//MAP CONVERTED BY dmm2tgm.py THIS HEADER COMMENT PREVENTS RECONVERSION, DO NOT REMOVE
"a" = (
/turf/closed/indestructible/riveted,
/area/ruin/unpowered)
"b" = (
/turf/open/lava/smooth/lava_land_surface,
/area/ruin/unpowered)
"c" = (
/obj/item/paper/fluff/stations/lavaland/sloth/note,
/turf/open/floor/sepia{
	slowdown = 10
	},
/area/ruin/unpowered)
"d" = (
/turf/open/floor/sepia{
	slowdown = 10
	},
/area/ruin/unpowered)
"e" = (
/obj/machinery/door/airlock/wood,
/turf/open/floor/sepia{
	slowdown = 10
	},
/area/ruin/unpowered)
"f" = (
/obj/structure/table/wood,
/obj/item/reagent_containers/food/snacks/grown/citrus/orange,
/turf/open/floor/sepia{
	slowdown = 10
	},
/area/ruin/unpowered)
"g" = (
/obj/structure/bed,
/obj/item/bedsheet/brown,
/turf/open/floor/sepia{
	slowdown = 10
	},
/area/ruin/unpowered)

(1,1,1) = {"
a
a
a
a
a
a
a
a
a
a
"}
(2,1,1) = {"
a
b
b
b
b
b
b
b
b
a
"}
(3,1,1) = {"
a
b
a
a
a
a
a
a
b
a
"}
(4,1,1) = {"
a
b
a
c
d
d
f
a
b
a
"}
(5,1,1) = {"
a
b
a
d
d
d
g
a
b
a
"}
(6,1,1) = {"
a
b
a
d
a
a
a
a
b
a
"}
(7,1,1) = {"
a
b
a
d
d
d
d
a
b
a
"}
(8,1,1) = {"
a
b
a
a
a
a
d
a
b
a
"}
(9,1,1) = {"
a
b
a
d
d
d
d
a
b
a
"}
(10,1,1) = {"
a
b
a
d
a
a
a
a
b
a
"}
(11,1,1) = {"
a
b
a
d
d
d
d
a
b
a
"}
(12,1,1) = {"
a
b
a
a
a
a
d
a
b
a
"}
(13,1,1) = {"
a
b
a
d
d
d
d
a
b
a
"}
(14,1,1) = {"
a
b
a
d
a
a
a
a
b
a
"}
(15,1,1) = {"
a
b
a
d
d
d
d
a
b
a
"}
(16,1,1) = {"
a
b
a
a
a
a
d
a
b
a
"}
(17,1,1) = {"
a
b
a
d
d
d
d
a
b
a
"}
(18,1,1) = {"
a
b
a
d
a
a
a
a
b
a
"}
(19,1,1) = {"
a
b
a
d
d
d
d
a
b
a
"}
(20,1,1) = {"
a
b
a
a
a
a
d
a
b
a
"}
(21,1,1) = {"
a
b
a
d
d
d
d
a
b
a
"}
(22,1,1) = {"
a
b
a
d
a
a
a
a
b
a
"}
(23,1,1) = {"
a
b
a
d
d
d
d
a
b
a
"}
(24,1,1) = {"
a
b
a
a
a
a
d
a
b
a
"}
(25,1,1) = {"
a
b
a
d
d
d
d
a
b
a
"}
(26,1,1) = {"
a
b
a
d
a
a
a
a
b
a
"}
(27,1,1) = {"
a
b
a
d
d
d
d
a
b
a
"}
(28,1,1) = {"
a
b
a
a
a
a
d
a
b
a
"}
(29,1,1) = {"
a
b
a
d
d
d
d
a
b
a
"}
(30,1,1) = {"
a
b
a
d
a
a
a
a
b
a
"}
(31,1,1) = {"
a
b
a
d
d
d
d
a
b
a
"}
(32,1,1) = {"
a
b
a
a
a
a
d
a
b
a
"}
(33,1,1) = {"
a
b
a
d
d
d
d
a
b
a
"}
(34,1,1) = {"
a
b
a
d
a
a
a
a
b
a
"}
(35,1,1) = {"
a
b
a
d
d
d
d
a
b
a
"}
(36,1,1) = {"
a
b
a
a
a
a
d
a
b
a
"}
(37,1,1) = {"
a
b
a
d
d
d
d
a
b
a
"}
(38,1,1) = {"
a
b
a
d
a
a
a
a
b
a
"}
(39,1,1) = {"
a
b
a
d
d
d
d
a
b
a
"}
(40,1,1) = {"
a
b
a
a
a
a
d
a
b
a
"}
(41,1,1) = {"
a
b
a
d
d
d
d
a
b
a
"}
(42,1,1) = {"
a
b
a
d
a
a
a
a
b
a
"}
(43,1,1) = {"
a
b
a
d
d
d
d
a
b
a
"}
(44,1,1) = {"
a
b
a
a
a
a
d
a
b
a
"}
(45,1,1) = {"
a
b
a
d
d
d
d
a
b
a
"}
(46,1,1) = {"
a
b
a
d
a
a
a
a
b
a
"}
(47,1,1) = {"
a
b
a
d
d
d
d
a
b
a
"}
(48,1,1) = {"
a
b
a
a
a
a
d
a
b
a
"}
(49,1,1) = {"
a
b
a
d
d
d
d
a
b
a
"}
(50,1,1) = {"
a
a
a
a
e
e
a
a
a
a
"}
