//MAP CONVERTED BY dmm2tgm.py THIS HEADER COMMENT PREVENTS RECONVERSION, DO NOT REMOVE
"a" = (
/turf/template_noop,
/area/lavaland/surface/outdoors)
"b" = (
/turf/closed/mineral/volcanic/lava_land_surface,
/area/lavaland/surface/outdoors)
"c" = (
/turf/open/floor/plating/asteroid/basalt/lava_land_surface,
/area/lavaland/surface/outdoors)
"d" = (
/obj/mecha/working/ripley/mining{
	ruin_mecha = 1
	},
/turf/open/floor/plating/asteroid/basalt/lava_land_surface,
/area/lavaland/surface/outdoors)
"e" = (
/obj/item/clothing/shoes/workboots/mining,
/obj/item/clothing/under/rank/cargo/miner/lavaland,
/obj/effect/decal/remains/human,
/turf/open/floor/plating/asteroid/basalt/lava_land_surface,
/area/lavaland/surface/outdoors)

(1,1,1) = {"
a
b
b
b
a
"}
(2,1,1) = {"
b
c
b
c
b
"}
(3,1,1) = {"
b
c
d
e
b
"}
(4,1,1) = {"
b
c
c
b
b
"}
(5,1,1) = {"
b
b
b
b
a
"}
