//MAP CONVERTED BY dmm2tgm.py THIS HEADER COMMENT PREVENTS RECONVERSION, DO NOT REMOVE
"a" = (
/turf/closed/mineral/volcanic/lava_land_surface,
/area/lavaland/surface/outdoors)
"b" = (
/turf/open/floor/plating/asteroid/basalt/lava_land_surface,
/area/lavaland/surface/outdoors)
"c" = (
/obj/effect/decal/remains/human,
/turf/open/floor/plating/asteroid/basalt/lava_land_surface,
/area/lavaland/surface/outdoors)
"d" = (
/turf/closed/indestructible/riveted,
/area/lavaland/surface/outdoors)
"e" = (
/obj/machinery/wish_granter,
/obj/effect/mapping_helpers/no_lava,
/turf/open/floor/plating/asteroid/basalt/lava_land_surface,
/area/lavaland/surface/outdoors)

(1,1,1) = {"
a
a
a
a
a
a
a
a
a
a
a
a
a
b
a
b
b
b
b
b
b
a
a
a
a
a
a
a
b
a
"}
(2,1,1) = {"
a
a
a
a
a
a
a
a
a
a
a
a
a
b
a
b
b
c
b
b
b
b
a
a
a
a
a
a
a
a
"}
(3,1,1) = {"
a
b
a
a
a
a
b
a
a
a
a
a
a
a
b
a
b
b
b
a
a
b
b
a
a
b
b
a
a
a
"}
(4,1,1) = {"
a
a
a
a
b
b
b
a
a
a
a
a
a
a
b
b
b
a
a
b
b
b
b
b
b
b
b
a
b
b
"}
(5,1,1) = {"
a
a
b
b
b
b
b
a
a
a
a
a
a
a
a
a
b
b
b
b
b
b
b
b
b
b
b
a
a
b
"}
(6,1,1) = {"
b
a
a
a
a
a
a
a
a
a
a
a
a
b
b
b
b
b
b
b
b
b
b
b
b
b
b
b
a
b
"}
(7,1,1) = {"
b
a
a
a
a
a
a
a
a
a
b
b
b
b
b
b
b
c
b
b
c
b
b
b
c
b
b
b
b
a
"}
(8,1,1) = {"
a
a
a
a
a
a
a
a
a
a
b
b
b
b
b
b
b
b
b
b
b
b
b
b
b
b
b
b
b
a
"}
(9,1,1) = {"
a
a
b
a
a
a
a
a
a
a
b
b
b
b
c
b
b
b
b
b
b
b
b
b
b
b
b
b
b
b
"}
(10,1,1) = {"
a
a
a
a
a
a
a
a
a
a
a
a
b
b
b
b
b
c
b
b
b
b
b
b
b
b
c
b
b
b
"}
(11,1,1) = {"
a
a
a
b
a
a
a
a
a
a
a
a
a
b
b
b
b
b
b
b
b
b
b
c
b
b
b
b
b
b
"}
(12,1,1) = {"
a
a
b
a
a
a
b
b
a
a
c
b
b
b
b
b
c
b
c
b
b
b
b
b
b
b
b
b
b
b
"}
(13,1,1) = {"
a
a
b
b
b
b
b
b
b
b
b
b
c
c
b
c
c
b
b
b
b
b
b
b
b
b
b
b
c
b
"}
(14,1,1) = {"
a
a
b
c
b
b
b
b
c
b
c
d
d
d
d
d
b
b
b
b
b
b
c
b
b
b
b
b
b
b
"}
(15,1,1) = {"
a
a
b
b
b
b
c
b
b
b
b
d
d
d
d
d
b
c
b
b
c
b
a
b
b
b
b
b
b
b
"}
(16,1,1) = {"
a
a
b
b
b
b
b
b
b
c
b
d
d
e
d
d
b
b
a
a
b
b
a
a
b
b
b
b
b
b
"}
(17,1,1) = {"
a
a
b
b
b
b
b
c
b
b
c
d
d
d
d
d
c
c
a
a
a
a
a
a
a
b
b
a
b
b
"}
(18,1,1) = {"
a
a
b
a
a
a
b
b
b
b
b
d
d
d
d
d
b
c
b
a
a
a
a
a
b
b
b
c
a
a
"}
(19,1,1) = {"
a
a
b
a
a
a
b
b
b
b
b
c
b
c
c
b
c
b
b
a
a
a
a
a
b
a
b
b
a
a
"}
(20,1,1) = {"
a
a
b
b
b
b
b
b
c
b
b
b
c
b
b
b
b
b
a
a
a
a
a
a
a
a
a
a
a
a
"}
(21,1,1) = {"
a
a
b
b
b
b
b
b
b
b
b
b
b
c
b
b
b
b
b
a
a
a
a
a
a
a
a
a
a
a
"}
(22,1,1) = {"
a
a
b
b
b
b
a
b
b
b
a
b
b
b
b
b
b
b
b
b
a
a
a
a
a
a
a
a
a
a
"}
(23,1,1) = {"
a
a
a
a
a
a
b
b
b
b
b
b
b
b
b
b
c
b
b
a
a
a
a
a
a
a
a
a
a
a
"}
(24,1,1) = {"
a
a
a
a
a
a
c
b
b
b
b
b
b
b
c
b
b
b
b
a
a
a
a
a
a
a
a
a
a
a
"}
(25,1,1) = {"
a
a
b
b
b
b
b
b
b
b
b
b
b
b
b
b
a
a
a
a
a
a
a
a
a
a
a
a
a
a
"}
(26,1,1) = {"
b
b
b
b
b
b
b
b
b
b
c
b
b
b
b
b
a
a
a
a
a
b
a
a
a
a
a
a
a
a
"}
(27,1,1) = {"
b
b
b
a
a
a
a
a
a
a
a
b
c
b
b
a
b
b
b
b
b
b
a
a
a
a
a
a
a
a
"}
(28,1,1) = {"
b
b
b
a
a
a
a
a
a
a
a
b
b
b
b
b
b
b
b
b
b
b
c
b
b
b
b
b
b
b
"}
(29,1,1) = {"
b
a
a
a
a
a
a
a
a
a
a
b
b
b
b
b
b
b
b
b
a
a
a
a
b
a
b
b
b
b
"}
(30,1,1) = {"
b
a
a
a
a
a
a
a
a
a
a
a
a
a
a
a
a
a
a
a
a
a
a
a
a
a
a
a
a
a
"}
