//MAP CONVERTED BY dmm2tgm.py THIS HEADER COMMENT PREVENTS RECONVERSION, DO NOT REMOVE
"a" = (
/turf/closed/mineral/volcanic/lava_land_surface,
/area/lavaland/surface/outdoors)
"b" = (
/turf/open/floor/plating/asteroid/basalt/lava_land_surface,
/area/lavaland/surface/outdoors)
"c" = (
/turf/open/lava/smooth/lava_land_surface,
/area/lavaland/surface/outdoors)
"e" = (
/turf/open/lava/smooth,
/area/ruin/powered/gluttony)
"f" = (
/obj/item/reagent_containers/syringe/gluttony,
/turf/open/floor/plasteel/freezer,
/area/ruin/powered/gluttony)
"g" = (
/obj/effect/gluttony,
/turf/open/floor/plasteel/freezer,
/area/ruin/powered/gluttony)
"h" = (
/obj/item/veilrender/vealrender,
/turf/open/floor/plasteel/freezer,
/area/ruin/powered/gluttony)
"i" = (
/turf/open/floor/plasteel/freezer,
/area/ruin/powered/gluttony)
"j" = (
/obj/item/trash/plate,
/turf/open/floor/plasteel/freezer,
/area/ruin/powered/gluttony)
"l" = (
/obj/item/trash/candy,
/turf/open/floor/plasteel/freezer,
/area/ruin/powered/gluttony)
"m" = (
/obj/item/trash/raisins,
/turf/open/floor/plasteel/freezer,
/area/ruin/powered/gluttony)
"n" = (
/obj/item/trash/pistachios,
/turf/open/floor/plasteel/freezer,
/area/ruin/powered/gluttony)
"o" = (
/obj/item/trash/popcorn,
/turf/open/floor/plasteel/freezer,
/area/ruin/powered/gluttony)
"p" = (
/obj/item/trash/semki,
/turf/open/floor/plasteel/freezer,
/area/ruin/powered/gluttony)
"q" = (
/obj/item/trash/syndi_cakes,
/turf/open/floor/plasteel/freezer,
/area/ruin/powered/gluttony)
"r" = (
/obj/effect/gluttony,
/obj/machinery/light/small{
	dir = 1
	},
/turf/open/floor/plasteel/freezer,
/area/ruin/powered/gluttony)
"t" = (
/obj/machinery/light/small{
	dir = 1
	},
/turf/open/floor/plasteel/freezer,
/area/ruin/powered/gluttony)
"v" = (
/obj/machinery/light/small,
/turf/open/floor/plasteel/freezer,
/area/ruin/powered/gluttony)
"z" = (
/obj/item/trash/plate,
/obj/machinery/light/small{
	dir = 8
	},
/turf/open/floor/plasteel/freezer,
/area/ruin/powered/gluttony)
"A" = (
/obj/machinery/light/small{
	dir = 4
	},
/turf/open/floor/plasteel/freezer,
/area/ruin/powered/gluttony)
"R" = (
/turf/closed/indestructible/riveted/uranium,
/area/ruin/powered/gluttony)
"S" = (
/obj/machinery/door/airlock/uranium,
/obj/structure/fans/tiny/invisible,
/turf/open/floor/plasteel/freezer,
/area/ruin/powered/gluttony)

(1,1,1) = {"
a
a
a
b
b
a
a
b
a
b
b
b
b
b
b
b
a
a
a
a
"}
(2,1,1) = {"
a
a
a
b
b
b
b
b
b
b
b
b
b
b
b
b
a
a
a
a
"}
(3,1,1) = {"
b
a
a
a
b
b
b
c
c
c
b
c
c
c
b
b
a
a
a
a
"}
(4,1,1) = {"
b
a
a
a
b
b
b
c
R
R
S
R
R
c
b
a
a
a
a
a
"}
(5,1,1) = {"
b
b
a
a
a
b
b
c
R
h
i
o
R
c
b
a
a
a
a
a
"}
(6,1,1) = {"
a
a
a
a
a
b
b
c
R
i
i
v
R
c
b
b
b
b
b
a
"}
(7,1,1) = {"
a
b
b
b
b
b
b
c
R
i
l
i
R
c
b
b
b
b
b
a
"}
(8,1,1) = {"
a
b
c
c
c
c
c
c
R
t
i
m
R
c
c
c
c
c
c
b
"}
(9,1,1) = {"
b
b
c
R
R
R
R
R
R
g
m
v
R
R
R
R
R
R
c
b
"}
(10,1,1) = {"
a
b
c
R
e
R
r
g
g
g
g
i
p
i
z
l
i
R
c
b
"}
(11,1,1) = {"
a
b
c
R
f
g
g
g
g
g
n
i
i
i
i
i
i
S
b
b
"}
(12,1,1) = {"
a
b
c
R
e
R
r
g
g
g
i
g
i
l
A
i
q
R
c
b
"}
(13,1,1) = {"
a
b
c
R
R
R
R
R
R
g
i
v
R
R
R
R
R
R
c
b
"}
(14,1,1) = {"
a
b
c
c
c
c
c
c
R
r
i
i
R
c
c
c
c
c
c
b
"}
(15,1,1) = {"
a
b
b
b
b
b
b
c
R
i
g
i
R
c
b
b
b
b
b
b
"}
(16,1,1) = {"
b
b
b
a
b
b
b
c
R
j
i
v
R
c
b
b
b
a
a
a
"}
(17,1,1) = {"
b
b
b
a
b
b
b
c
R
i
n
i
R
c
b
b
b
a
a
a
"}
(18,1,1) = {"
a
a
a
a
b
b
b
c
R
R
S
R
R
c
b
b
b
a
a
a
"}
(19,1,1) = {"
a
a
a
a
a
a
a
c
c
c
b
c
c
c
b
b
a
a
a
a
"}
(20,1,1) = {"
a
a
a
a
a
a
a
b
b
b
b
b
b
b
a
a
b
a
a
a
"}
