//MAP CONVERTED BY dmm2tgm.py THIS HEADER COMMENT PREVENTS RECONVERSION, DO NOT REMOVE
"a" = (
/turf/template_noop,
/area/template_noop)
"b" = (
/turf/open/floor/plating/asteroid/basalt/lava_land_surface,
/area/lavaland/surface/outdoors/unexplored)
"c" = (
/obj/structure/fluff/clockwork/alloy_shards/small,
/turf/open/floor/plating/asteroid/basalt/lava_land_surface,
/area/lavaland/surface/outdoors/unexplored)
"d" = (
/obj/structure/girder/bronze,
/turf/open/floor/plating/asteroid/basalt/lava_land_surface,
/area/lavaland/surface/outdoors/unexplored)
"e" = (
/obj/item/stack/tile/bronze,
/turf/open/floor/bronze{
	initial_gas_mix = "LAVALAND_ATMOS"
	},
/area/lavaland/surface/outdoors/unexplored)
"f" = (
/turf/closed/mineral/volcanic/lava_land_surface,
/area/lavaland/surface/outdoors/unexplored)
"g" = (
/obj/structure/fluff/clockwork/alloy_shards/medium_gearbit,
/turf/open/floor/plating/asteroid/basalt/lava_land_surface,
/area/lavaland/surface/outdoors/unexplored)
"h" = (
/turf/open/floor/bronze{
	initial_gas_mix = "LAVALAND_ATMOS"
	},
/area/lavaland/surface/outdoors/unexplored)
"i" = (
/obj/structure/grille/broken,
/turf/open/floor/plating/asteroid/basalt/lava_land_surface,
/area/lavaland/surface/outdoors/unexplored)
"j" = (
/turf/closed/wall/mineral/bronze,
/area/lavaland/surface/outdoors/unexplored)
"k" = (
/obj/structure/fluff/clockwork/alloy_shards/small,
/turf/open/floor/bronze{
	initial_gas_mix = "LAVALAND_ATMOS"
	},
/area/lavaland/surface/outdoors/unexplored)
"l" = (
/turf/open/lava/smooth/lava_land_surface,
/area/lavaland/surface/outdoors/unexplored)
"m" = (
/obj/structure/fluff/clockwork/alloy_shards/medium,
/turf/open/floor/plating/asteroid/basalt/lava_land_surface,
/area/lavaland/surface/outdoors/unexplored)
"n" = (
/obj/structure/fluff/clockwork/blind_eye,
/turf/open/floor/plating/asteroid/basalt/lava_land_surface,
/area/lavaland/surface/outdoors/unexplored)
"o" = (
/obj/structure/fluff/clockwork/alloy_shards/large,
/turf/open/floor/plating/asteroid/basalt/lava_land_surface,
/area/lavaland/surface/outdoors/unexplored)
"p" = (
/obj/structure/fluff/clockwork/alloy_shards/medium,
/turf/open/floor/bronze{
	initial_gas_mix = "LAVALAND_ATMOS"
	},
/area/lavaland/surface/outdoors/unexplored)
"q" = (
/obj/structure/lattice,
/turf/open/lava/smooth/lava_land_surface,
/area/lavaland/surface/outdoors/unexplored)
"r" = (
/obj/structure/lattice,
/turf/open/floor/plating/asteroid/basalt/lava_land_surface,
/area/lavaland/surface/outdoors/unexplored)
"s" = (
/obj/structure/fluff/clockwork/alloy_shards/large,
/turf/open/floor/bronze{
	initial_gas_mix = "LAVALAND_ATMOS"
	},
/area/lavaland/surface/outdoors/unexplored)
"t" = (
/obj/item/stack/tile/bronze,
/turf/open/floor/plating/asteroid/basalt/lava_land_surface,
/area/lavaland/surface/outdoors/unexplored)
"u" = (
/obj/structure/grille,
/turf/open/floor/bronze{
	initial_gas_mix = "LAVALAND_ATMOS"
	},
/area/lavaland/surface/outdoors/unexplored)
"v" = (
/obj/structure/fluff/clockwork/alloy_shards/medium,
/obj/structure/lattice,
/turf/open/floor/plating/asteroid/basalt/lava_land_surface,
/area/lavaland/surface/outdoors/unexplored)
"w" = (
/obj/structure/grille/broken,
/turf/open/floor/bronze{
	initial_gas_mix = "LAVALAND_ATMOS"
	},
/area/lavaland/surface/outdoors/unexplored)
"x" = (
/obj/structure/girder/bronze,
/obj/item/stack/tile/bronze,
/turf/open/floor/bronze{
	initial_gas_mix = "LAVALAND_ATMOS"
	},
/area/lavaland/surface/outdoors/unexplored)
"y" = (
/obj/structure/fluff/clockwork/fallen_armor,
/turf/open/floor/bronze{
	initial_gas_mix = "LAVALAND_ATMOS"
	},
/area/lavaland/surface/outdoors/unexplored)
"z" = (
/obj/structure/girder/bronze,
/turf/open/floor/bronze{
	initial_gas_mix = "LAVALAND_ATMOS"
	},
/area/lavaland/surface/outdoors/unexplored)
"A" = (
/obj/structure/fluff/clockwork/clockgolem_remains,
/turf/open/floor/bronze{
	initial_gas_mix = "LAVALAND_ATMOS"
	},
/area/lavaland/surface/outdoors/unexplored)
"B" = (
/obj/item/nullrod/spear,
/turf/open/floor/bronze{
	initial_gas_mix = "LAVALAND_ATMOS"
	},
/area/lavaland/surface/outdoors/unexplored)
"C" = (
/obj/structure/fluff/clockwork/alloy_shards/medium_gearbit,
/turf/open/floor/bronze{
	initial_gas_mix = "LAVALAND_ATMOS"
	},
/area/lavaland/surface/outdoors/unexplored)
"D" = (
/obj/structure/grille,
/turf/open/floor/plating/asteroid/basalt/lava_land_surface,
/area/lavaland/surface/outdoors/unexplored)
"E" = (
/obj/structure/fluff/clockwork/clockgolem_remains,
/turf/open/floor/plating/asteroid/basalt/lava_land_surface,
/area/lavaland/surface/outdoors/unexplored)
"F" = (
/obj/structure/dead_ratvar,
/turf/open/floor/bronze{
	initial_gas_mix = "LAVALAND_ATMOS"
	},
/area/lavaland/surface/outdoors/unexplored)
"G" = (
/obj/item/stack/tile/bronze/thirty,
/turf/open/floor/plating/asteroid/basalt/lava_land_surface,
/area/lavaland/surface/outdoors/unexplored)

(1,1,1) = {"
a
a
a
a
a
a
a
a
a
a
a
a
a
b
s
h
b
a
a
a
a
a
a
a
"}
(2,1,1) = {"
a
a
a
a
a
a
a
o
b
a
h
b
r
c
j
x
b
b
g
a
a
a
a
a
"}
(3,1,1) = {"
a
a
a
a
a
a
f
b
l
b
v
b
p
w
j
j
c
l
b
b
a
a
a
a
"}
(4,1,1) = {"
a
a
a
a
a
a
f
l
l
r
b
b
l
j
j
j
p
l
b
h
c
r
a
a
"}
(5,1,1) = {"
a
a
a
a
a
b
l
l
p
h
c
l
l
l
j
l
b
l
l
D
h
r
a
a
"}
(6,1,1) = {"
a
a
a
h
c
h
m
l
l
c
l
l
l
l
w
l
l
l
m
c
h
f
a
a
"}
(7,1,1) = {"
a
a
b
b
b
l
l
l
l
h
b
l
l
l
l
l
l
l
l
c
f
f
b
a
"}
(8,1,1) = {"
a
h
h
g
c
b
l
l
l
l
n
h
r
l
l
b
l
l
l
l
f
b
a
a
"}
(9,1,1) = {"
a
b
c
b
b
l
l
l
l
t
h
b
h
w
p
b
g
l
l
b
b
b
b
a
"}
(10,1,1) = {"
b
h
l
l
l
l
l
l
b
b
p
r
F
b
h
A
b
l
l
l
m
l
l
a
"}
(11,1,1) = {"
c
i
j
j
l
l
l
l
l
b
h
k
h
h
h
r
l
l
l
l
l
l
b
a
"}
(12,1,1) = {"
d
j
j
j
h
l
l
b
l
q
r
h
h
h
c
q
l
b
l
l
b
h
o
a
"}
(13,1,1) = {"
e
k
b
l
l
l
b
p
s
r
h
h
h
h
h
h
h
l
l
l
l
b
b
a
"}
(14,1,1) = {"
b
b
b
m
l
l
l
b
h
h
k
h
h
h
h
h
c
b
l
l
b
b
h
b
"}
(15,1,1) = {"
b
b
b
l
l
l
l
h
h
h
h
h
h
h
k
B
h
l
l
l
l
b
b
a
"}
(16,1,1) = {"
f
l
l
l
l
l
l
q
b
h
h
h
h
h
h
s
b
l
l
l
l
f
f
a
"}
(17,1,1) = {"
b
b
b
l
l
l
b
l
q
r
h
h
h
h
h
b
s
r
l
r
l
l
b
a
"}
(18,1,1) = {"
b
h
l
l
l
b
b
h
b
h
h
h
h
h
r
k
b
C
r
h
b
b
m
b
"}
(19,1,1) = {"
b
b
l
l
l
l
h
b
h
h
h
h
h
h
h
r
j
h
c
h
r
h
b
b
"}
(20,1,1) = {"
b
l
l
l
l
b
b
p
h
c
h
k
h
h
o
b
l
l
l
b
E
r
G
o
"}
(21,1,1) = {"
g
b
l
l
l
l
l
r
h
r
h
h
h
h
y
l
l
l
l
l
l
j
j
r
"}
(22,1,1) = {"
c
c
b
l
l
b
h
h
t
b
h
h
h
h
h
m
b
l
l
l
h
j
j
j
"}
(23,1,1) = {"
b
h
m
n
b
h
l
o
j
u
r
p
h
r
h
b
l
l
l
b
b
w
r
b
"}
(24,1,1) = {"
a
a
b
b
l
l
l
j
j
q
p
h
m
e
z
j
j
l
l
c
l
l
b
a
"}
(25,1,1) = {"
a
a
a
l
l
l
l
j
l
l
b
h
r
x
h
l
l
l
l
l
l
a
a
a
"}
(26,1,1) = {"
a
a
a
c
b
l
l
l
l
l
l
g
q
b
h
l
l
l
c
m
b
a
a
a
"}
(27,1,1) = {"
a
a
a
b
h
b
l
l
l
l
l
l
l
l
l
l
l
l
l
b
a
a
a
a
"}
(28,1,1) = {"
a
a
a
a
c
b
l
b
l
l
l
l
l
l
l
l
b
l
f
a
a
a
a
a
"}
(29,1,1) = {"
a
a
a
a
b
b
f
c
b
l
c
l
l
l
l
c
o
l
b
a
a
a
a
a
"}
(30,1,1) = {"
a
a
a
a
a
g
c
b
l
l
b
m
l
b
l
f
b
a
a
a
a
a
a
a
"}
(31,1,1) = {"
a
a
a
a
a
a
a
b
l
b
a
b
l
c
f
f
a
a
a
a
a
a
a
a
"}
(32,1,1) = {"
a
a
a
a
a
a
a
a
a
a
a
a
a
a
c
a
a
a
a
a
a
a
a
a
"}
