//MAP CONVERTED BY dmm2tgm.py THIS HEADER COMMENT PREVENTS RECONVERSION, DO NOT REMOVE
"a" = (
/turf/closed/indestructible/riveted/hierophant,
/area/ruin/unpowered/hierophant)
"b" = (
/turf/open/indestructible/hierophant,
/area/ruin/unpowered/hierophant)
"c" = (
/obj/effect/light_emitter{
	set_cap = 3;
	set_luminosity = 5
	},
/turf/open/indestructible/hierophant,
/area/ruin/unpowered/hierophant)
"d" = (
/mob/living/simple_animal/hostile/megafauna/hierophant,
/turf/open/indestructible/hierophant/two,
/area/ruin/unpowered/hierophant)
"e" = (
/turf/open/indestructible/hierophant/two,
/area/ruin/unpowered/hierophant)
"f" = (
/obj/effect/light_emitter{
	set_cap = 3;
	set_luminosity = 5
	},
/turf/open/indestructible/hierophant/two,
/area/ruin/unpowered/hierophant)

(1,1,1) = {"
a
a
a
b
b
b
b
a
a
a
a
a
a
a
a
a
b
b
b
b
a
a
a
"}
(2,1,1) = {"
a
b
b
b
b
b
b
b
b
b
b
c
b
b
b
b
b
b
b
b
b
b
a
"}
(3,1,1) = {"
a
b
b
b
c
c
b
b
b
a
b
b
b
a
b
b
b
c
c
b
b
b
a
"}
(4,1,1) = {"
b
b
b
b
b
b
b
b
b
b
b
b
b
b
b
b
b
b
b
b
b
b
b
"}
(5,1,1) = {"
b
b
c
b
a
a
b
c
b
b
b
c
b
b
b
c
b
a
a
b
c
b
b
"}
(6,1,1) = {"
b
b
c
b
a
a
b
c
b
b
b
c
b
b
b
c
b
a
a
b
c
b
b
"}
(7,1,1) = {"
b
b
b
b
b
b
e
e
e
e
e
e
e
e
e
e
e
b
b
b
b
b
b
"}
(8,1,1) = {"
a
b
b
b
c
c
e
e
e
a
e
e
e
a
e
e
e
c
c
b
b
b
a
"}
(9,1,1) = {"
a
b
b
b
b
b
e
e
e
e
e
f
e
e
e
e
e
b
b
b
b
b
a
"}
(10,1,1) = {"
a
b
a
b
b
b
e
a
e
e
e
e
e
e
e
a
e
b
b
b
a
b
a
"}
(11,1,1) = {"
a
b
b
b
b
b
e
e
e
e
e
e
e
e
e
e
e
b
b
b
b
b
a
"}
(12,1,1) = {"
a
c
b
b
c
c
e
e
f
e
e
d
e
e
f
e
e
c
c
b
b
c
a
"}
(13,1,1) = {"
a
b
b
b
b
b
e
e
e
e
e
e
e
e
e
e
e
b
b
b
b
b
a
"}
(14,1,1) = {"
a
b
a
b
b
b
e
a
e
e
e
e
e
e
e
a
e
b
b
b
a
b
a
"}
(15,1,1) = {"
a
b
b
b
b
b
e
e
e
e
e
f
e
e
e
e
e
b
b
b
b
b
a
"}
(16,1,1) = {"
a
b
b
b
c
c
e
e
e
a
e
e
e
a
e
e
e
c
c
b
b
b
a
"}
(17,1,1) = {"
b
b
b
b
b
b
e
e
e
e
e
e
e
e
e
e
e
b
b
b
b
b
b
"}
(18,1,1) = {"
b
b
c
b
a
a
b
c
b
b
b
c
b
b
b
c
b
a
a
b
c
b
b
"}
(19,1,1) = {"
b
b
c
b
a
a
b
c
b
b
b
c
b
b
b
c
b
a
a
b
c
b
b
"}
(20,1,1) = {"
b
b
b
b
b
b
b
b
b
b
b
b
b
b
b
b
b
b
b
b
b
b
b
"}
(21,1,1) = {"
a
b
b
b
c
c
b
b
b
a
b
b
b
a
b
b
b
c
c
b
b
b
a
"}
(22,1,1) = {"
a
b
b
b
b
b
b
b
b
b
b
c
b
b
b
b
b
b
b
b
b
b
a
"}
(23,1,1) = {"
a
a
a
b
b
b
b
a
a
a
a
a
a
a
a
a
b
b
b
b
a
a
a
"}
