//MAP CONVERTED BY dmm2tgm.py THIS HEADER COMMENT PREVENTS RECONVERSION, DO NOT REMOVE
"a" = (
/turf/template_noop,
/area/template_noop)
"b" = (
/turf/open/floor/plating/asteroid/airless,
/area/ruin/unpowered/no_grav)
"c" = (
/turf/closed/mineral/random/high_chance,
/area/ruin/unpowered/no_grav)

(1,1,1) = {"
a
a
a
a
a
a
a
a
a
a
b
b
b
a
a
a
a
"}
(2,1,1) = {"
a
b
b
a
a
a
a
a
a
c
c
c
b
a
a
a
b
"}
(3,1,1) = {"
a
b
b
a
a
a
a
b
b
c
c
c
b
a
a
a
a
"}
(4,1,1) = {"
a
a
b
a
a
a
a
b
c
c
c
a
a
a
a
a
a
"}
(5,1,1) = {"
a
a
a
a
a
a
b
c
c
c
b
a
a
a
a
a
a
"}
(6,1,1) = {"
a
a
a
a
a
a
a
b
b
a
a
a
a
a
a
a
a
"}
(7,1,1) = {"
a
a
a
b
a
a
a
a
a
a
a
a
a
a
a
a
a
"}
(8,1,1) = {"
a
a
a
b
b
b
a
a
a
a
a
a
a
a
a
a
a
"}
(9,1,1) = {"
a
a
a
c
b
a
a
a
a
b
b
a
a
a
a
b
b
"}
(10,1,1) = {"
a
a
a
b
a
a
a
a
a
b
b
b
a
a
a
c
b
"}
(11,1,1) = {"
a
a
a
a
a
a
a
a
a
c
c
b
a
a
a
a
a
"}
(12,1,1) = {"
a
a
a
a
a
a
a
b
b
c
c
a
a
a
a
a
a
"}
(13,1,1) = {"
a
a
a
a
a
a
a
b
c
b
a
a
a
a
a
a
a
"}
(14,1,1) = {"
a
a
a
a
a
a
a
b
b
b
a
a
a
a
a
a
a
"}
(15,1,1) = {"
b
a
a
a
a
a
a
a
a
a
a
a
a
a
a
a
a
"}
