//MAP CONVERTED BY dmm2tgm.py THIS HEADER COMMENT PREVENTS RECONVERSION, DO NOT REMOVE
"a" = (
/turf/template_noop,
/area/template_noop)
"b" = (
/turf/open/floor/plating/asteroid/airless,
/area/ruin/unpowered/no_grav)
"c" = (
/turf/closed/mineral/random/no_caves,
/area/ruin/unpowered/no_grav)
"d" = (
/turf/closed/mineral/random/high_chance,
/area/ruin/unpowered/no_grav)
"e" = (
/obj/effect/decal/remains/human,
/turf/open/floor/plating/asteroid/airless,
/area/ruin/unpowered/no_grav)
"f" = (
/obj/item/pickaxe/diamond,
/turf/open/floor/plating/asteroid/airless,
/area/ruin/unpowered/no_grav)

(1,1,1) = {"
a
a
b
a
a
a
a
a
b
c
c
c
c
b
a
a
a
a
"}
(2,1,1) = {"
a
a
a
a
a
a
a
b
b
d
d
c
c
c
c
c
a
a
"}
(3,1,1) = {"
b
b
a
b
b
b
a
b
b
d
d
c
c
d
d
d
b
a
"}
(4,1,1) = {"
b
b
b
b
c
c
b
b
c
d
d
c
c
d
d
d
b
a
"}
(5,1,1) = {"
b
b
c
c
c
c
c
c
c
c
c
c
c
d
d
d
c
a
"}
(6,1,1) = {"
a
b
c
c
c
c
c
c
c
c
b
c
c
c
c
c
b
a
"}
(7,1,1) = {"
a
a
b
b
c
d
c
c
b
b
b
b
c
c
c
c
b
a
"}
(8,1,1) = {"
a
b
b
c
c
c
c
b
b
b
f
b
b
c
c
b
b
b
"}
(9,1,1) = {"
a
b
b
c
c
c
c
b
b
e
b
b
b
c
c
c
b
b
"}
(10,1,1) = {"
a
b
b
c
c
b
b
b
b
b
b
b
c
c
c
c
c
b
"}
(11,1,1) = {"
a
b
b
c
c
c
c
c
b
b
c
c
c
c
d
d
b
b
"}
(12,1,1) = {"
a
a
b
d
d
c
c
c
c
c
c
c
c
c
d
d
b
b
"}
(13,1,1) = {"
a
a
b
d
d
c
c
c
d
c
c
c
c
c
c
b
b
a
"}
(14,1,1) = {"
a
a
b
d
d
c
c
c
c
c
c
c
c
b
b
b
a
a
"}
(15,1,1) = {"
b
a
b
c
c
c
c
c
c
c
c
c
c
b
a
a
a
b
"}
(16,1,1) = {"
a
a
b
b
b
c
c
c
c
c
c
b
b
a
a
a
a
a
"}
(17,1,1) = {"
a
a
a
b
b
c
c
d
d
c
c
b
b
a
a
a
a
a
"}
(18,1,1) = {"
a
a
a
a
a
a
c
d
d
a
a
a
a
a
a
a
a
a
"}
(19,1,1) = {"
a
a
b
a
a
a
a
a
a
a
a
a
b
a
a
a
b
a
"}
