//MAP CONVERTED BY dmm2tgm.py THIS HEADER COMMENT PREVENTS RECONVERSION, DO NOT REMOVE
"a" = (
/turf/template_noop,
/area/template_noop)
"b" = (
/turf/open/floor/plating/asteroid/airless,
/area/ruin/unpowered/no_grav)
"c" = (
/turf/closed/mineral/random/no_caves,
/area/ruin/unpowered/no_grav)
"d" = (
/turf/closed/mineral/random/high_chance,
/area/ruin/unpowered/no_grav)

(1,1,1) = {"
a
a
a
a
a
a
a
a
a
a
a
a
a
a
a
a
b
a
"}
(2,1,1) = {"
a
a
a
b
b
b
b
a
a
a
a
a
a
a
a
a
a
a
"}
(3,1,1) = {"
a
a
b
b
b
b
b
a
b
b
b
b
a
a
a
a
a
a
"}
(4,1,1) = {"
a
b
b
b
b
b
b
b
b
b
b
b
b
a
a
b
a
a
"}
(5,1,1) = {"
a
b
b
b
c
c
c
c
b
b
b
b
b
b
a
a
a
a
"}
(6,1,1) = {"
b
b
b
b
c
c
c
c
d
d
d
d
d
b
a
a
a
a
"}
(7,1,1) = {"
b
b
b
c
c
c
c
c
d
d
d
d
d
b
b
b
a
a
"}
(8,1,1) = {"
b
b
c
c
c
c
d
c
c
c
c
c
c
b
b
b
a
a
"}
(9,1,1) = {"
b
b
b
c
c
c
d
c
c
c
c
d
d
d
c
b
b
a
"}
(10,1,1) = {"
a
b
b
b
c
c
d
d
c
c
d
d
c
c
c
b
b
a
"}
(11,1,1) = {"
a
b
b
b
c
c
c
d
d
d
d
d
c
c
c
b
b
a
"}
(12,1,1) = {"
a
a
b
b
d
d
c
d
d
d
d
c
c
c
b
c
b
a
"}
(13,1,1) = {"
a
a
b
b
d
d
d
c
c
c
c
c
c
c
c
c
b
b
"}
(14,1,1) = {"
a
a
b
b
b
b
b
c
c
c
c
c
c
d
c
c
c
b
"}
(15,1,1) = {"
a
a
a
a
b
b
b
c
d
c
c
d
d
d
c
c
c
b
"}
(16,1,1) = {"
a
a
a
a
a
a
b
b
b
c
c
d
d
d
b
b
b
b
"}
(17,1,1) = {"
a
b
a
a
a
a
b
b
b
b
b
b
b
b
b
b
a
a
"}
(18,1,1) = {"
a
b
b
a
a
a
a
a
b
b
b
b
b
b
b
a
a
a
"}
(19,1,1) = {"
a
a
a
a
a
a
a
a
b
b
b
b
b
b
b
a
a
a
"}
(20,1,1) = {"
b
a
a
a
a
a
a
a
a
a
a
a
a
a
a
a
a
a
"}
