//MAP CONVERTED BY dmm2tgm.py THIS HEADER COMMENT PREVENTS RECONVERSION, DO NOT REMOVE
"a" = (
/turf/template_noop,
/area/template_noop)
"b" = (
/turf/closed/mineral/random/no_caves,
/area/ruin/unpowered)
"c" = (
/turf/closed/mineral/random/high_chance,
/area/ruin/unpowered)
"d" = (
/turf/open/floor/plating/asteroid/airless,
/area/ruin/unpowered)

(1,1,1) = {"
a
a
a
a
a
a
a
a
a
a
a
a
a
a
a
a
a
a
a
a
a
a
a
a
a
a
a
a
a
a
b
c
c
c
a
a
a
a
"}
(2,1,1) = {"
a
a
a
a
a
a
a
a
a
a
a
a
a
a
a
a
a
a
a
a
a
a
a
a
a
a
a
a
a
a
b
c
c
c
c
b
a
a
"}
(3,1,1) = {"
a
a
a
a
a
b
b
c
c
a
a
a
a
a
a
a
a
a
a
a
a
a
a
a
a
a
a
a
d
d
d
b
c
c
c
b
b
b
"}
(4,1,1) = {"
a
a
a
a
a
b
b
b
b
b
a
a
a
a
a
a
a
a
a
a
a
a
a
a
a
a
d
d
d
d
d
b
b
b
b
b
b
b
"}
(5,1,1) = {"
a
a
a
c
c
c
b
b
b
b
b
b
b
a
a
a
a
a
a
a
a
a
a
a
a
a
d
d
d
d
d
b
b
b
b
b
b
b
"}
(6,1,1) = {"
a
a
a
c
c
c
c
b
b
b
b
b
b
c
c
c
a
a
a
a
a
a
a
a
b
b
d
d
d
d
b
b
b
b
b
b
b
b
"}
(7,1,1) = {"
a
a
a
c
c
c
c
b
b
b
b
b
b
c
c
c
a
a
a
a
a
a
a
b
d
d
d
d
b
c
c
c
c
b
b
b
b
b
"}
(8,1,1) = {"
a
a
b
c
c
c
b
b
b
d
d
d
d
b
b
b
a
a
a
a
a
a
a
d
d
d
b
b
b
c
c
c
c
b
b
c
c
a
"}
(9,1,1) = {"
a
a
b
b
b
b
b
d
d
d
d
d
d
d
d
b
a
a
a
a
a
a
b
d
d
b
b
b
b
c
c
c
c
b
b
c
c
a
"}
(10,1,1) = {"
a
b
b
b
b
b
c
d
d
d
a
a
d
d
d
c
a
a
a
a
a
a
d
d
d
b
c
c
c
c
c
c
c
b
b
b
b
a
"}
(11,1,1) = {"
a
b
b
b
b
b
d
d
a
a
a
a
d
d
d
b
a
a
a
a
a
a
d
d
b
b
c
c
c
c
d
d
d
b
b
b
a
a
"}
(12,1,1) = {"
a
b
b
b
b
d
d
a
a
a
a
a
a
a
a
a
a
a
a
a
a
a
d
d
c
c
c
d
d
d
d
d
d
b
b
b
b
a
"}
(13,1,1) = {"
a
b
b
b
c
d
d
a
a
a
a
a
a
a
a
a
a
a
a
a
a
b
d
d
c
c
b
d
d
c
d
d
d
b
b
b
b
a
"}
(14,1,1) = {"
a
b
b
b
c
d
a
a
a
a
a
a
a
a
a
a
a
a
a
a
a
d
d
b
c
c
b
d
d
b
d
d
d
b
b
b
b
a
"}
(15,1,1) = {"
b
b
b
d
d
d
a
a
a
a
a
b
a
a
a
a
a
a
a
a
a
d
d
b
c
c
b
b
b
b
d
d
d
b
b
b
b
a
"}
(16,1,1) = {"
b
b
b
d
d
d
a
a
a
a
a
a
a
a
a
a
a
a
a
a
a
d
d
b
c
c
b
b
d
d
d
d
d
b
b
b
b
b
"}
(17,1,1) = {"
b
b
b
d
d
d
a
a
a
a
a
a
a
a
a
b
b
b
a
a
a
d
d
b
b
b
b
b
d
d
d
d
b
b
b
b
c
c
"}
(18,1,1) = {"
c
c
d
d
d
a
a
b
b
a
a
a
a
a
a
b
b
b
b
a
a
d
d
b
b
b
b
d
d
d
c
b
b
c
c
b
c
c
"}
(19,1,1) = {"
c
c
d
d
d
a
a
b
b
b
a
a
a
a
b
b
c
c
b
a
a
b
d
b
b
b
b
d
d
d
b
b
b
c
c
b
c
c
"}
(20,1,1) = {"
c
c
d
d
d
a
a
b
b
b
a
a
a
a
b
b
b
a
a
a
a
b
d
d
d
b
b
d
d
d
d
b
b
b
b
b
c
c
"}
(21,1,1) = {"
c
c
b
d
d
a
a
a
a
a
a
a
a
a
a
a
a
a
a
a
a
b
d
d
d
c
c
c
b
d
d
b
b
b
b
b
b
b
"}
(22,1,1) = {"
b
b
b
d
d
a
a
a
a
a
a
a
a
a
a
a
a
a
a
a
a
a
d
d
d
c
c
c
b
d
d
b
b
b
b
b
b
b
"}
(23,1,1) = {"
a
b
b
d
d
d
a
a
a
a
a
a
a
a
b
a
a
a
a
a
a
a
a
a
d
d
d
d
d
d
d
b
b
b
b
b
b
a
"}
(24,1,1) = {"
a
b
b
c
d
d
d
d
a
a
a
a
a
a
a
a
a
a
a
a
a
a
a
a
b
c
d
d
d
d
d
b
b
b
b
b
b
a
"}
(25,1,1) = {"
a
b
b
b
b
d
d
d
a
a
a
a
a
a
a
a
a
a
a
a
a
a
a
a
a
a
d
d
d
d
d
c
c
b
a
a
a
a
"}
(26,1,1) = {"
a
b
b
b
b
d
d
d
a
a
a
a
a
a
a
a
a
a
a
a
a
a
a
a
a
a
a
a
a
a
a
a
a
a
a
a
a
a
"}
(27,1,1) = {"
a
b
b
c
c
b
b
b
a
a
a
b
b
a
a
a
a
a
a
a
a
b
a
a
a
a
a
a
a
a
a
a
a
a
a
a
a
a
"}
(28,1,1) = {"
a
a
b
c
c
b
b
b
b
b
b
b
b
a
a
a
a
d
d
d
b
b
b
a
a
a
a
a
a
a
a
a
a
a
a
a
a
a
"}
(29,1,1) = {"
a
a
a
a
a
a
b
b
b
b
b
a
a
a
a
a
a
d
d
d
c
b
b
a
a
a
a
a
a
a
a
a
a
a
a
a
a
a
"}
(30,1,1) = {"
a
a
a
a
a
a
a
a
a
a
a
a
a
a
a
a
a
d
d
d
b
b
b
b
b
b
a
a
a
a
a
a
a
a
a
a
a
a
"}
(31,1,1) = {"
a
a
a
a
a
a
a
a
a
a
a
a
a
a
a
d
d
d
d
d
b
b
b
b
b
b
b
a
a
a
a
a
a
a
a
a
a
a
"}
(32,1,1) = {"
a
a
a
a
a
a
a
a
a
a
a
a
a
a
a
d
d
d
b
b
b
b
b
b
b
b
c
a
a
a
a
a
a
a
a
a
a
a
"}
(33,1,1) = {"
a
a
a
a
a
a
a
a
a
a
a
a
a
a
d
d
d
d
d
d
d
c
c
c
b
b
c
b
a
a
a
a
a
a
a
b
b
a
"}
(34,1,1) = {"
a
a
a
a
a
a
a
a
a
a
a
a
a
a
d
d
d
d
d
d
d
d
d
d
b
b
b
b
a
a
a
a
a
a
b
b
b
a
"}
(35,1,1) = {"
a
a
a
a
a
a
a
a
a
a
a
b
b
b
d
d
d
b
b
b
d
d
d
d
b
b
b
c
a
a
a
a
a
b
b
b
b
a
"}
(36,1,1) = {"
a
a
a
a
a
a
a
a
a
a
b
c
c
c
b
b
b
b
b
b
b
d
d
b
b
b
a
a
a
a
a
a
a
b
b
b
a
a
"}
(37,1,1) = {"
a
a
a
a
a
a
a
a
a
b
c
c
c
c
b
b
b
b
b
b
c
c
b
b
b
b
a
a
a
a
a
a
a
a
a
a
a
a
"}
(38,1,1) = {"
a
a
a
a
a
a
a
a
a
a
a
c
c
c
b
a
a
a
b
b
b
b
b
a
a
a
a
a
a
a
a
a
a
a
a
a
a
a
"}
