//MAP CONVERTED BY dmm2tgm.py THIS HEADER COMMENT PREVENTS RECONVERSION, DO NOT REMOVE
"a" = (
/turf/template_noop,
/area/template_noop)
"b" = (
/turf/closed/mineral/random/no_caves,
/area/ruin/unpowered/no_grav)
"c" = (
/turf/open/floor/plating/asteroid/airless,
/area/ruin/unpowered/no_grav)
"d" = (
/turf/closed/wall,
/area/ruin/unpowered/no_grav)
"e" = (
/turf/closed/wall/rust,
/area/ruin/unpowered/no_grav)
"f" = (
/obj/item/stack/rods{
	amount = 2
	},
/obj/item/shard,
/turf/open/floor/plating/asteroid/airless,
/area/ruin/unpowered/no_grav)
"g" = (
/obj/structure/grille,
/obj/structure/window/fulltile,
/turf/open/floor/plating,
/area/ruin/unpowered/no_grav)
"h" = (
/obj/structure/grille/broken,
/obj/structure/barricade/wooden/crude,
/obj/structure/trap/cult,
/obj/effect/decal/cleanable/glass,
/turf/open/floor/plating/airless,
/area/ruin/unpowered/no_grav)
"i" = (
/obj/structure/light_prism,
/turf/open/floor/plasteel/airless/dark,
/area/ruin/unpowered/no_grav)
"j" = (
/obj/effect/decal/cleanable/blood/drip,
/turf/open/floor/plating/airless,
/area/ruin/unpowered/no_grav)
"k" = (
/obj/item/ectoplasm,
/turf/open/floor/plating/asteroid/airless,
/area/ruin/unpowered/no_grav)
"l" = (
/obj/structure/closet/crate/coffin,
/turf/open/floor/plasteel/airless/dark,
/area/ruin/unpowered/no_grav)
"m" = (
/turf/open/floor/plating/airless,
/area/ruin/unpowered/no_grav)
"n" = (
/turf/open/floor/carpet/royalblack/airless,
/area/ruin/unpowered/no_grav)
"o" = (
/obj/structure/table/wood/fancy,
/obj/item/reagent_containers/food/drinks/bottle/holywater,
/turf/open/floor/carpet/airless,
/area/ruin/unpowered/no_grav)
"p" = (
/obj/structure/table/wood/fancy,
/obj/item/melee/cleric_mace,
/turf/open/floor/carpet/airless,
/area/ruin/unpowered/no_grav)
"q" = (
/obj/effect/decal/cleanable/shreds,
/turf/open/floor/carpet/airless,
/area/ruin/unpowered/no_grav)
"r" = (
/obj/effect/decal/cleanable/shreds,
/obj/effect/decal/remains/human,
/obj/item/disk/design_disk/adv/cleric_mace,
/obj/structure/trap/cult,
/turf/open/floor/carpet/airless,
/area/ruin/unpowered/no_grav)
"s" = (
/obj/effect/decal/cleanable/shreds,
/turf/open/floor/carpet/royalblack/airless,
/area/ruin/unpowered/no_grav)
"t" = (
/turf/open/floor/carpet/royalblue/airless,
/area/ruin/unpowered/no_grav)
"u" = (
/turf/open/floor/carpet/airless,
/area/ruin/unpowered/no_grav)
"v" = (
/obj/effect/decal/cleanable/blood/splatter,
/obj/effect/decal/cleanable/blood/footprints,
/obj/effect/decal/cleanable/shreds,
/turf/open/floor/carpet/airless,
/area/ruin/unpowered/no_grav)
"w" = (
/obj/effect/decal/cleanable/blood/drip,
/turf/open/floor/carpet/royalblack/airless,
/area/ruin/unpowered/no_grav)
"x" = (
/obj/structure/bonfire,
/turf/open/floor/plasteel/airless/dark,
/area/ruin/unpowered/no_grav)
"y" = (
/obj/effect/decal/cleanable/blood/tracks,
/turf/open/floor/carpet/airless,
/area/ruin/unpowered/no_grav)
"z" = (
/obj/item/paper/fluff/ruins/clericsden/contact,
/turf/open/floor/plating/airless,
/area/ruin/unpowered/no_grav)
"A" = (
/obj/structure/table/wood{
	layer = 3.3
	},
/turf/open/floor/carpet/royalblack/airless,
/area/ruin/unpowered/no_grav)
"B" = (
/obj/effect/decal/cleanable/blood/footprints,
/obj/effect/decal/cleanable/blood/tracks,
/turf/open/floor/carpet/airless,
/area/ruin/unpowered/no_grav)
"C" = (
/obj/structure/chair/wood{
	dir = 1
	},
/turf/open/floor/carpet/royalblue/airless,
/area/ruin/unpowered/no_grav)
"D" = (
/obj/effect/decal/remains/human,
/obj/structure/trap/cult,
/turf/open/floor/carpet/airless,
/area/ruin/unpowered/no_grav)
"E" = (
/obj/effect/decal/cleanable/blood/tracks,
/mob/living/simple_animal/hostile/construct/proteon/hostile,
/turf/open/floor/carpet/airless,
/area/ruin/unpowered/no_grav)
"F" = (
/obj/item/flashlight/flare/torch,
/turf/open/floor/plating/airless,
/area/ruin/unpowered/no_grav)
"G" = (
/obj/effect/decal/cleanable/blood/tracks,
/obj/structure/trap/cult,
/turf/open/floor/carpet/airless,
/area/ruin/unpowered/no_grav)
"H" = (
/obj/structure/light_prism,
/turf/open/floor/plating/airless,
/area/ruin/unpowered/no_grav)
"I" = (
/obj/effect/decal/cleanable/blood/drip,
/turf/open/floor/carpet/airless,
/area/ruin/unpowered/no_grav)
"J" = (
/obj/structure/rack,
/obj/item/tank/internals/emergency_oxygen,
/obj/item/clothing/mask/breath,
/turf/open/floor/plasteel/airless/dark,
/area/ruin/unpowered/no_grav)
"K" = (
/obj/structure/grille,
/obj/structure/window/fulltile,
/turf/open/floor/plating/airless,
/area/ruin/unpowered/no_grav)
"L" = (
/obj/machinery/door/airlock/wood,
/turf/open/floor/plating/airless,
/area/ruin/unpowered/no_grav)
"M" = (
/obj/effect/decal/cleanable/blood/tracks,
/obj/machinery/door/airlock/wood,
/turf/open/floor/plating/airless,
/area/ruin/unpowered/no_grav)
"N" = (
/mob/living/simple_animal/hostile/construct/proteon,
/turf/open/floor/plating/asteroid/airless,
/area/ruin/unpowered/no_grav)
"O" = (
/obj/structure/grille,
/obj/structure/window/fulltile,
/obj/structure/barricade/wooden/crude,
/turf/open/floor/plating/airless,
/area/ruin/unpowered/no_grav)
"Q" = (
/obj/item/storage/book/bible,
/obj/effect/decal/cleanable/blood,
/turf/open/floor/plating/asteroid/airless,
/area/ruin/unpowered/no_grav)
"S" = (
/obj/effect/decal/cleanable/blood/drip,
/turf/open/floor/plating/asteroid/airless,
/area/ruin/unpowered/no_grav)
"U" = (
/obj/effect/decal/remains/human,
/obj/item/paper/fluff/ruins/clericsden/warning,
/turf/open/floor/plating/asteroid/airless,
/area/ruin/unpowered/no_grav)

(1,1,1) = {"
a
a
a
a
a
a
a
a
c
b
c
c
c
c
a
a
a
a
"}
(2,1,1) = {"
a
a
a
c
c
c
c
c
c
c
c
b
c
c
b
c
c
a
"}
(3,1,1) = {"
a
c
b
c
c
b
c
b
c
c
b
b
b
c
b
b
b
a
"}
(4,1,1) = {"
a
b
b
b
b
b
b
b
b
b
b
b
b
b
b
b
c
a
"}
(5,1,1) = {"
a
b
d
d
e
d
e
K
d
d
d
d
d
d
e
c
c
a
"}
(6,1,1) = {"
a
b
e
i
l
e
x
m
e
x
m
e
m
J
d
e
b
a
"}
(7,1,1) = {"
a
a
e
j
n
n
t
w
A
C
n
A
C
n
H
e
d
a
"}
(8,1,1) = {"
a
f
h
m
o
q
u
u
u
D
u
u
u
u
I
L
c
c
"}
(9,1,1) = {"
a
b
g
m
p
r
v
y
B
E
B
y
B
G
B
M
U
S
"}
(10,1,1) = {"
a
b
d
m
n
s
t
n
A
C
n
A
C
n
H
d
e
c
"}
(11,1,1) = {"
a
c
e
i
l
d
x
z
e
x
F
e
m
J
e
d
b
b
"}
(12,1,1) = {"
a
a
e
e
d
d
e
O
d
d
d
e
e
d
d
b
b
c
"}
(13,1,1) = {"
a
b
b
b
b
b
b
b
b
b
b
b
b
b
b
b
c
c
"}
(14,1,1) = {"
a
c
b
b
b
c
b
b
c
b
c
Q
b
b
b
c
S
a
"}
(15,1,1) = {"
a
a
c
c
c
c
c
c
N
c
c
c
c
S
c
c
a
a
"}
(16,1,1) = {"
a
a
k
c
b
b
c
c
b
c
c
b
c
b
b
b
a
a
"}
(17,1,1) = {"
a
b
c
b
c
b
b
b
b
b
b
b
b
b
c
a
a
a
"}
(18,1,1) = {"
b
b
b
a
a
c
c
c
c
c
c
c
c
a
a
a
a
a
"}
(19,1,1) = {"
a
b
a
a
a
a
a
a
a
a
a
a
a
a
a
a
a
a
"}
