//MAP CONVERTED BY dmm2tgm.py THIS HEADER COMMENT PREVENTS RECONVERSION, DO NOT REMOVE
"a" = (
/turf/template_noop,
/area/template_noop)
"b" = (
/turf/open/floor/plating/airless,
/area/ruin/unpowered/no_grav)
"c" = (
/turf/closed/wall,
/area/ruin/unpowered/no_grav)
"d" = (
/obj/structure/lattice,
/turf/template_noop,
/area/space/nearstation)
"e" = (
/obj/structure/lattice,
/obj/structure/lattice,
/turf/template_noop,
/area/space/nearstation)

(1,1,1) = {"
a
a
a
a
a
a
a
a
a
a
a
a
a
a
a
a
a
a
a
a
a
a
a
c
c
c
c
c
a
a
"}
(2,1,1) = {"
a
a
a
a
a
a
a
a
a
a
a
a
a
a
a
a
a
a
a
a
a
a
b
b
b
b
b
b
c
a
"}
(3,1,1) = {"
a
a
a
a
a
a
a
a
a
a
a
a
a
a
a
a
a
a
a
a
a
a
b
b
b
b
b
b
b
c
"}
(4,1,1) = {"
a
a
a
a
a
a
a
a
a
a
a
a
a
a
a
a
a
a
a
a
a
a
a
d
b
b
b
b
b
c
"}
(5,1,1) = {"
a
a
a
a
a
a
a
a
a
a
a
a
a
a
a
a
a
a
a
a
a
a
a
d
d
d
b
b
b
c
"}
(6,1,1) = {"
a
a
a
a
a
a
a
a
a
a
a
a
a
a
a
a
a
a
a
a
a
a
a
d
d
d
b
b
b
c
"}
(7,1,1) = {"
a
a
a
a
a
a
a
a
a
a
a
a
a
a
a
a
a
a
a
a
a
a
a
a
d
d
d
b
b
c
"}
(8,1,1) = {"
a
a
a
a
a
a
a
a
a
a
a
a
a
a
a
a
a
a
a
a
a
a
a
a
d
d
d
b
b
a
"}
(9,1,1) = {"
a
a
a
a
a
a
a
a
a
a
a
a
a
a
a
a
a
a
a
a
a
a
a
d
d
a
e
d
b
a
"}
(10,1,1) = {"
a
a
a
a
a
a
a
a
a
a
a
a
a
a
a
a
a
a
a
a
a
a
a
a
a
a
a
a
a
a
"}
(11,1,1) = {"
a
a
a
a
a
a
a
a
a
a
a
a
a
a
a
a
a
a
a
a
d
d
a
a
a
a
a
a
a
a
"}
(12,1,1) = {"
a
a
a
a
a
a
a
a
a
a
a
a
a
a
a
a
a
d
d
d
d
a
a
a
a
a
a
a
a
a
"}
(13,1,1) = {"
a
a
a
a
a
a
a
a
a
a
a
a
a
a
a
d
d
d
d
d
a
a
a
a
a
a
a
a
a
a
"}
(14,1,1) = {"
a
a
a
a
a
a
a
a
a
a
a
a
a
b
b
b
b
d
d
d
a
a
a
a
a
a
a
a
a
a
"}
(15,1,1) = {"
a
a
a
a
a
a
a
a
a
a
d
d
b
b
c
b
b
b
d
a
a
a
a
a
a
a
a
a
a
a
"}
(16,1,1) = {"
a
a
a
a
a
a
a
a
a
d
d
b
b
b
c
b
b
b
d
a
a
a
a
a
a
a
a
a
a
a
"}
(17,1,1) = {"
a
a
a
a
a
a
a
a
d
d
b
b
b
b
c
b
b
b
d
a
a
a
a
a
a
a
a
a
a
a
"}
(18,1,1) = {"
a
a
a
a
a
a
d
d
b
d
b
c
c
c
b
c
b
b
d
a
a
a
a
a
a
a
a
a
a
a
"}
(19,1,1) = {"
a
a
a
d
d
d
d
d
d
d
b
c
b
b
b
b
b
b
d
a
a
a
a
a
a
a
a
a
a
a
"}
(20,1,1) = {"
a
a
a
b
b
b
d
d
d
d
b
b
b
b
b
b
d
d
d
a
a
a
a
a
a
a
a
a
a
a
"}
(21,1,1) = {"
a
b
b
b
b
b
b
d
d
d
b
b
b
b
d
d
d
d
d
a
a
a
a
a
a
a
a
a
a
a
"}
(22,1,1) = {"
b
b
b
b
c
b
b
d
d
d
d
b
b
b
d
d
b
d
a
a
a
a
a
a
a
a
a
a
a
a
"}
(23,1,1) = {"
b
b
b
c
b
b
b
b
d
d
d
d
d
d
d
d
d
d
a
a
a
a
a
a
a
a
a
a
a
a
"}
(24,1,1) = {"
b
b
c
c
c
c
b
b
d
d
b
d
d
d
d
d
d
d
d
a
a
a
a
a
a
a
a
a
a
a
"}
(25,1,1) = {"
b
b
b
c
b
b
b
b
d
d
d
d
d
b
b
b
b
b
d
d
a
a
a
a
a
a
a
a
a
a
"}
(26,1,1) = {"
a
b
b
b
c
c
b
d
d
d
d
b
b
b
b
b
b
b
b
d
a
a
a
a
a
a
a
a
a
a
"}
(27,1,1) = {"
a
b
b
b
b
b
b
d
d
d
d
b
b
b
b
b
b
b
b
a
a
a
a
a
a
a
a
a
a
a
"}
(28,1,1) = {"
a
a
a
b
b
b
b
d
d
d
b
b
b
b
b
c
b
b
b
b
a
a
a
a
a
a
a
a
a
a
"}
(29,1,1) = {"
a
a
a
d
d
d
d
d
d
d
b
b
b
b
c
c
c
c
b
b
a
a
a
a
a
a
a
a
a
a
"}
(30,1,1) = {"
a
a
a
a
a
d
d
b
d
d
b
b
c
c
b
c
b
b
b
a
a
a
a
a
a
a
a
a
a
a
"}
(31,1,1) = {"
a
a
a
a
a
a
d
d
d
d
b
b
b
b
b
c
b
b
a
a
a
a
a
a
a
a
a
a
a
a
"}
(32,1,1) = {"
a
a
a
a
a
a
a
d
d
d
d
d
b
b
b
b
a
a
a
a
a
a
a
a
a
a
a
a
a
a
"}
