//MAP CONVERTED BY dmm2tgm.py THIS HEADER COMMENT PREVENTS RECONVERSION, DO NOT REMOVE
"a" = (
/turf/template_noop,
/area/template_noop)
"b" = (
/turf/closed/mineral/random/no_caves,
/area/ruin/unpowered/no_grav)
"c" = (
/turf/open/floor/plating/asteroid/airless,
/area/ruin/unpowered/no_grav)
"d" = (
/turf/closed/mineral/random/no_caves,
/area/ruin/unpowered)
"e" = (
/turf/closed/wall,
/area/ruin/unpowered)
"f" = (
/turf/closed/wall/rust,
/area/ruin/unpowered)
"g" = (
/turf/open/floor/plating,
/area/ruin/unpowered)
"h" = (
/obj/structure/closet/crate,
/turf/open/floor/plating,
/area/ruin/unpowered)
"i" = (
/obj/effect/spawner/lootdrop/crate_spawner,
/turf/open/floor/plating,
/area/ruin/unpowered)
"j" = (
/obj/structure/barricade/wooden,
/obj/structure/door_assembly,
/turf/open/floor/plating,
/area/ruin/unpowered)
"k" = (
/obj/structure/table,
/obj/item/storage/toolbox/electrical,
/turf/open/floor/plating,
/area/ruin/unpowered)
"l" = (
/obj/structure/closet/crate,
/obj/effect/spawner/lootdrop/maintenance,
/turf/open/floor/plating,
/area/ruin/unpowered)
"m" = (
/obj/effect/decal/remains/human,
/turf/open/floor/plating,
/area/ruin/unpowered)
"n" = (
/obj/structure/table,
/obj/item/storage/toolbox/syndicate,
/turf/open/floor/plating,
/area/ruin/unpowered)
"o" = (
/obj/structure/table,
/turf/open/floor/plating,
/area/ruin/unpowered)
"p" = (
/turf/open/floor/plating/asteroid,
/area/ruin/unpowered)
"q" = (
/obj/structure/barricade/wooden,
/turf/open/floor/plating,
/area/ruin/unpowered)
"r" = (
/obj/structure/barricade/wooden,
/obj/machinery/door/airlock/external,
/turf/open/floor/plating/asteroid/airless,
/area/ruin/unpowered)
"s" = (
/obj/machinery/door/airlock/external,
/turf/open/floor/plating,
/area/ruin/unpowered)

(1,1,1) = {"
a
a
a
a
a
a
a
a
a
a
a
a
a
a
a
a
a
a
a
a
a
a
a
a
a
a
a
a
a
a
a
b
b
b
a
a
a
a
"}
(2,1,1) = {"
a
a
a
a
a
a
a
a
a
a
a
a
a
a
a
a
a
a
a
a
a
a
a
a
a
a
a
a
a
a
a
b
b
b
a
a
a
a
"}
(3,1,1) = {"
a
a
a
a
a
a
a
a
a
a
a
a
a
a
a
a
a
a
b
a
a
a
a
a
a
a
a
a
a
a
a
a
a
b
a
a
a
b
"}
(4,1,1) = {"
a
a
a
a
a
a
a
a
a
a
a
a
a
a
a
a
a
a
a
a
a
a
a
a
a
a
a
a
a
a
a
a
a
a
a
a
a
a
"}
(5,1,1) = {"
a
a
a
a
a
a
a
a
a
c
c
c
c
a
a
a
a
a
a
a
a
a
b
a
a
a
a
a
a
a
a
a
a
a
a
a
b
a
"}
(6,1,1) = {"
a
a
a
a
a
a
a
c
c
c
c
c
c
a
a
a
a
a
a
a
a
a
a
a
a
a
a
a
a
a
a
a
a
a
a
a
a
a
"}
(7,1,1) = {"
a
a
a
a
a
a
b
b
b
b
b
c
c
c
c
a
a
a
a
a
a
a
a
a
b
b
b
a
a
a
a
a
a
a
a
a
a
a
"}
(8,1,1) = {"
a
a
a
a
a
b
b
b
b
b
b
c
c
c
c
c
c
c
a
a
a
a
a
a
b
b
b
a
a
a
a
a
a
a
a
a
a
a
"}
(9,1,1) = {"
a
a
a
a
a
b
b
b
b
b
b
b
b
b
c
c
c
c
c
a
a
a
a
a
a
b
b
b
b
a
a
a
a
a
a
a
a
a
"}
(10,1,1) = {"
a
a
a
a
a
b
b
b
b
b
b
b
b
b
b
b
b
c
c
a
a
a
a
a
a
b
b
b
b
a
a
a
a
a
a
a
a
a
"}
(11,1,1) = {"
a
a
a
a
b
b
b
b
b
b
b
b
b
b
b
b
b
c
c
c
c
a
a
a
a
a
a
a
a
a
a
a
a
a
a
a
a
a
"}
(12,1,1) = {"
a
a
a
a
b
b
b
b
b
b
b
b
b
b
b
b
b
b
c
c
c
a
a
a
a
a
a
a
a
a
a
a
a
a
a
a
a
a
"}
(13,1,1) = {"
a
a
a
a
b
b
b
b
b
b
b
b
b
b
b
b
b
b
c
c
c
c
c
a
a
a
a
a
a
a
a
a
a
a
a
a
a
a
"}
(14,1,1) = {"
a
a
a
a
b
b
b
b
b
d
d
f
f
e
f
e
e
e
d
b
c
c
c
a
a
a
a
a
a
a
a
a
a
a
a
a
a
a
"}
(15,1,1) = {"
a
a
a
a
b
b
b
b
b
d
g
i
i
m
g
f
g
g
d
b
c
c
c
a
a
a
a
a
a
a
a
a
a
a
a
a
a
a
"}
(16,1,1) = {"
a
a
a
a
a
a
b
b
b
e
g
g
g
g
h
f
g
g
e
b
c
c
c
a
a
a
a
a
a
a
a
a
a
a
a
a
a
a
"}
(17,1,1) = {"
a
a
a
a
a
a
b
b
b
e
g
g
k
n
i
e
g
g
d
b
c
c
c
c
a
a
a
a
a
a
b
b
b
a
a
a
a
a
"}
(18,1,1) = {"
a
a
a
a
a
a
b
b
b
f
e
j
f
f
e
e
p
l
e
b
b
b
c
c
c
c
c
a
a
a
b
b
b
b
b
a
a
a
"}
(19,1,1) = {"
a
a
a
a
a
a
a
b
b
d
g
g
l
h
l
e
g
g
f
b
b
b
c
c
c
c
c
c
c
c
c
c
b
b
b
a
a
a
"}
(20,1,1) = {"
a
a
a
a
a
a
a
b
b
d
g
g
g
g
g
e
g
p
f
b
b
b
c
c
c
c
c
c
c
c
c
c
b
b
b
b
b
a
"}
(21,1,1) = {"
a
a
a
a
a
a
a
b
b
e
g
g
g
g
g
j
g
g
e
b
b
b
c
c
c
c
c
c
c
c
c
c
c
c
b
b
b
a
"}
(22,1,1) = {"
a
a
a
a
a
a
a
a
b
e
h
h
g
o
g
e
g
p
e
e
e
b
c
c
c
c
c
c
c
c
c
c
c
c
b
b
b
b
"}
(23,1,1) = {"
a
a
a
a
a
a
a
a
b
d
f
f
j
f
g
e
p
q
r
q
s
c
c
c
c
c
c
c
c
c
c
c
c
c
b
b
b
b
"}
(24,1,1) = {"
a
a
a
a
a
a
a
a
a
d
i
h
g
f
l
e
e
d
e
e
e
b
c
c
c
c
c
c
c
c
c
c
c
c
b
b
b
b
"}
(25,1,1) = {"
a
b
a
a
a
a
a
a
a
b
b
e
f
e
b
b
b
b
b
b
b
b
c
c
c
c
c
c
c
c
c
c
c
c
c
b
b
b
"}
(26,1,1) = {"
a
a
a
a
a
a
a
a
a
b
b
b
b
b
b
b
b
b
b
b
b
b
b
b
b
c
c
c
c
c
c
c
c
c
c
c
b
b
"}
(27,1,1) = {"
a
a
a
a
a
a
a
a
a
b
b
b
b
b
b
b
b
b
b
b
b
b
b
b
b
b
c
c
c
c
c
c
c
c
c
c
b
b
"}
(28,1,1) = {"
a
a
a
a
a
a
a
a
a
b
b
b
b
b
b
b
b
b
b
b
b
b
b
b
b
b
c
c
c
c
c
c
c
c
c
c
b
b
"}
(29,1,1) = {"
a
a
a
a
a
a
a
a
a
b
b
b
b
b
b
b
b
b
b
b
b
b
b
b
b
c
c
c
c
c
c
c
c
c
c
c
b
b
"}
(30,1,1) = {"
a
b
b
a
a
a
a
a
a
a
b
b
b
b
b
b
b
b
b
b
b
b
b
b
b
c
c
c
c
c
c
c
c
c
b
b
b
b
"}
(31,1,1) = {"
b
b
b
a
a
a
a
a
a
a
b
b
b
b
b
b
b
b
b
b
b
b
b
b
b
b
c
c
c
c
c
c
c
c
b
b
b
a
"}
(32,1,1) = {"
b
b
b
b
a
a
a
a
a
a
a
a
b
b
b
b
b
b
b
b
b
b
b
b
b
b
c
c
c
c
c
c
b
b
b
b
b
a
"}
(33,1,1) = {"
a
b
b
b
a
a
a
a
a
a
a
a
b
b
b
b
b
b
b
b
b
b
b
b
b
b
b
b
b
b
c
c
b
b
b
b
b
a
"}
(34,1,1) = {"
b
a
a
a
a
a
a
b
a
a
a
a
a
a
b
b
b
b
b
b
b
b
b
b
b
b
b
b
b
b
b
b
b
b
b
b
a
a
"}
(35,1,1) = {"
b
a
a
a
a
a
a
a
a
a
a
a
a
a
b
b
b
b
b
b
b
b
b
b
b
b
b
b
b
b
b
b
b
b
b
b
a
a
"}
(36,1,1) = {"
a
a
a
a
b
a
a
a
a
a
a
a
a
a
a
a
a
a
a
b
b
b
b
b
b
b
b
b
b
b
b
b
b
b
b
b
a
a
"}
(37,1,1) = {"
a
a
a
a
a
a
a
a
a
a
a
a
a
a
a
a
a
a
a
a
a
a
a
a
a
a
b
b
b
b
b
b
b
a
a
a
a
a
"}
