//MAP CONVERTED BY dmm2tgm.py THIS HEADER COMMENT PREVENTS RECONVERSION, DO NOT REMOVE
"a" = (
/turf/template_noop,
/area/template_noop)
"b" = (
/turf/closed/mineral/random/no_caves,
/area/ruin/unpowered)
"c" = (
/turf/open/floor/plating/asteroid/airless,
/area/ruin/unpowered)
"d" = (
/turf/closed/mineral/random/high_chance,
/area/ruin/unpowered)
"e" = (
/turf/closed/wall/mineral/titanium,
/area/ruin/unpowered)
"f" = (
/obj/machinery/door/airlock/titanium,
/turf/open/floor/plating/airless,
/area/ruin/unpowered)
"g" = (
/turf/open/floor/plating/airless,
/area/ruin/unpowered)
"h" = (
/turf/open/floor/mineral/titanium/blue/airless,
/area/ruin/unpowered)
"i" = (
/obj/structure/chair,
/obj/structure/window/reinforced{
	dir = 8
	},
/turf/open/floor/mineral/titanium/blue/airless,
/area/ruin/unpowered)
"j" = (
/obj/structure/chair,
/turf/open/floor/mineral/titanium/blue/airless,
/area/ruin/unpowered)
"k" = (
/obj/effect/spawner/lootdrop/crate_spawner,
/turf/open/floor/mineral/titanium/blue/airless,
/area/ruin/unpowered)
"l" = (
/obj/structure/shuttle/engine/propulsion{
	dir = 4
	},
/turf/open/floor/plating/airless,
/area/ruin/unpowered)
"m" = (
/obj/item/shard,
/turf/open/floor/plating/airless,
/area/ruin/unpowered)
"n" = (
/obj/structure/chair{
	dir = 8
	},
/turf/open/floor/plating/airless,
/area/ruin/unpowered)
"o" = (
/obj/structure/grille,
/turf/open/floor/plating/airless,
/area/ruin/unpowered)
"p" = (
/obj/structure/table,
/turf/open/floor/mineral/titanium/blue/airless,
/area/ruin/unpowered)
"q" = (
/obj/item/shard,
/obj/structure/chair{
	dir = 8
	},
/turf/open/floor/mineral/titanium/blue/airless,
/area/ruin/unpowered)
"r" = (
/obj/structure/chair{
	dir = 1
	},
/obj/structure/window/reinforced{
	dir = 8
	},
/turf/open/floor/mineral/titanium/blue/airless,
/area/ruin/unpowered)
"s" = (
/obj/structure/chair{
	dir = 1
	},
/turf/open/floor/plating/airless,
/area/ruin/unpowered)
"t" = (
/obj/structure/girder,
/turf/open/floor/plating/airless,
/area/ruin/unpowered)

(1,1,1) = {"
a
a
a
a
a
a
a
a
a
a
a
a
a
a
a
a
a
a
a
a
a
b
a
a
a
a
a
a
a
a
a
a
a
a
a
"}
(2,1,1) = {"
a
a
a
a
a
a
a
a
a
a
a
a
a
a
a
a
a
a
a
a
a
a
a
a
b
b
a
a
a
a
a
a
a
a
a
"}
(3,1,1) = {"
a
a
c
c
a
a
a
a
a
a
a
a
a
a
a
a
a
a
a
a
a
a
a
b
b
b
a
a
a
a
a
a
a
a
a
"}
(4,1,1) = {"
a
b
c
c
c
a
a
a
a
a
a
a
a
a
a
a
a
a
a
b
a
a
a
b
b
a
a
a
a
a
a
a
a
a
a
"}
(5,1,1) = {"
b
b
c
c
c
a
a
a
a
a
a
a
a
a
a
a
a
a
a
a
a
a
a
a
a
a
a
a
a
a
a
a
a
a
a
"}
(6,1,1) = {"
b
b
b
b
b
a
a
a
a
a
a
c
c
a
a
a
a
a
a
a
a
a
a
a
a
a
a
a
a
a
a
a
a
a
a
"}
(7,1,1) = {"
b
b
b
b
b
a
a
a
a
a
a
c
c
c
c
c
c
c
a
a
a
a
a
a
a
a
a
a
a
a
a
a
a
a
a
"}
(8,1,1) = {"
a
a
b
b
a
a
a
a
a
a
a
c
c
c
c
c
c
c
b
b
b
a
a
a
a
a
a
a
a
a
a
a
a
a
a
"}
(9,1,1) = {"
a
a
b
b
a
a
a
a
a
b
c
c
c
c
c
c
c
c
c
b
b
a
a
a
a
a
a
a
a
a
a
a
a
a
a
"}
(10,1,1) = {"
a
a
a
a
a
a
a
a
a
b
b
b
c
c
c
c
c
c
c
b
b
b
a
a
a
a
a
a
a
a
a
a
a
a
a
"}
(11,1,1) = {"
a
a
a
a
a
a
a
a
b
b
b
b
b
b
c
c
b
b
b
b
b
b
b
a
a
a
a
a
a
a
a
a
a
a
a
"}
(12,1,1) = {"
a
a
a
a
a
a
a
a
b
b
b
b
d
d
b
b
b
b
b
b
b
b
d
a
a
a
a
a
a
a
b
b
b
a
a
"}
(13,1,1) = {"
a
a
a
a
a
a
a
a
d
d
b
b
d
d
b
b
b
d
b
b
b
b
b
a
a
a
a
a
a
a
a
b
b
b
a
"}
(14,1,1) = {"
a
a
a
a
a
a
a
a
d
d
b
b
b
b
b
b
b
b
b
b
b
b
b
b
a
a
a
a
a
a
b
b
b
b
b
"}
(15,1,1) = {"
a
a
a
a
a
a
a
a
d
d
d
b
b
b
g
g
o
b
b
c
b
b
d
d
a
a
a
a
a
d
b
b
b
c
c
"}
(16,1,1) = {"
a
a
a
a
a
a
a
a
d
d
b
b
c
e
g
m
p
g
e
c
b
b
d
d
a
a
a
a
d
d
b
b
d
c
c
"}
(17,1,1) = {"
a
a
a
a
a
a
a
a
d
b
b
b
c
e
g
n
q
h
e
c
b
b
d
d
a
a
a
d
b
b
b
c
c
c
a
"}
(18,1,1) = {"
a
a
a
a
a
a
a
a
b
b
b
b
c
e
g
h
h
h
e
c
c
b
b
b
a
a
a
b
b
b
b
c
c
c
a
"}
(19,1,1) = {"
a
a
a
a
a
a
a
a
b
b
b
c
c
e
h
h
h
h
e
c
c
c
c
b
a
a
d
b
b
c
c
c
c
c
a
"}
(20,1,1) = {"
a
a
a
a
a
a
a
a
a
b
b
c
c
f
h
h
h
h
f
c
c
c
c
b
a
b
b
b
b
c
c
c
a
a
a
"}
(21,1,1) = {"
a
a
a
a
a
a
a
a
a
b
b
b
c
e
i
h
h
r
e
c
c
c
c
a
a
b
b
b
c
c
c
a
a
a
a
"}
(22,1,1) = {"
a
a
a
a
a
a
b
a
a
b
b
b
c
e
j
h
h
s
t
c
c
c
c
a
a
b
b
c
a
a
a
a
a
a
a
"}
(23,1,1) = {"
a
a
a
a
a
a
a
a
b
b
b
d
c
e
k
h
g
g
g
c
c
a
a
a
a
a
b
c
a
a
a
a
a
a
a
"}
(24,1,1) = {"
a
a
a
b
b
a
a
a
b
b
b
d
c
e
e
e
e
e
e
c
c
a
a
a
a
a
a
a
a
a
a
a
a
a
a
"}
(25,1,1) = {"
a
a
b
b
b
a
a
a
b
b
b
d
c
e
l
l
l
l
e
c
c
a
a
a
a
a
a
a
a
a
a
a
a
a
a
"}
(26,1,1) = {"
a
a
a
b
b
a
a
a
b
b
b
b
b
c
c
c
c
c
c
c
c
a
a
a
a
a
a
a
a
a
a
a
a
a
a
"}
(27,1,1) = {"
a
a
a
a
a
a
a
a
a
b
b
b
c
c
c
c
c
a
a
a
a
a
a
a
a
a
a
a
a
a
a
a
a
a
a
"}
(28,1,1) = {"
a
a
a
a
a
a
a
a
a
a
b
b
c
c
c
c
c
a
a
a
a
a
a
a
a
a
a
a
a
a
a
a
a
a
a
"}
(29,1,1) = {"
a
a
a
a
a
a
a
a
a
a
a
a
a
a
a
a
a
a
a
a
a
a
a
a
a
a
a
a
a
a
a
a
a
a
a
"}
(30,1,1) = {"
a
a
a
a
a
a
a
a
a
a
a
a
a
a
a
a
a
a
a
a
a
a
a
a
a
a
a
a
a
a
a
a
a
a
a
"}
(31,1,1) = {"
a
a
a
a
a
a
a
a
a
a
a
a
a
a
a
a
a
a
a
a
a
a
a
a
a
a
c
c
c
a
a
a
a
a
a
"}
(32,1,1) = {"
a
a
a
a
a
a
a
a
a
a
a
a
a
a
a
a
a
a
a
a
a
a
a
a
a
c
c
b
b
a
a
a
a
a
a
"}
(33,1,1) = {"
a
a
a
a
a
a
a
a
a
a
a
a
a
a
a
a
a
a
a
a
a
a
a
a
a
c
c
d
b
a
a
a
a
a
a
"}
(34,1,1) = {"
a
a
a
a
a
a
a
a
a
a
a
a
a
a
a
a
a
a
a
a
a
a
a
b
a
b
d
b
b
a
a
a
a
a
a
"}
(35,1,1) = {"
a
a
a
a
a
a
a
a
a
a
a
a
a
a
a
a
a
a
a
a
a
a
a
a
a
b
b
a
a
a
a
a
a
a
a
"}
