//MAP CONVERTED BY dmm2tgm.py THIS HEADER COMMENT PREVENTS RECONVERSION, DO NOT REMOVE
"a" = (
/turf/template_noop,
/area/template_noop)
"b" = (
/turf/closed/mineral/random/no_caves,
/area/ruin/space/has_grav)
"c" = (
/turf/open/floor/plating/asteroid/airless,
/area/ruin/space/has_grav)
"d" = (
/obj/structure/marker_beacon{
	light_color = "#FFE8AA";
	light_range = 20
	},
/turf/open/floor/plating/asteroid/airless,
/area/ruin/space/has_grav)
"e" = (
/obj/structure/flora/ausbushes/fullgrass,
/turf/open/floor/plating/asteroid/airless,
/area/ruin/space/has_grav)
"f" = (
/obj/structure/flora/ausbushes/ywflowers,
/turf/open/floor/plating/asteroid/airless,
/area/ruin/space/has_grav)
"h" = (
/mob/living/simple_animal/pet/gondola,
/turf/open/floor/plating/asteroid/airless,
/area/ruin/space/has_grav)
"i" = (
/obj/structure/flora/ausbushes/sparsegrass,
/turf/open/floor/plating/asteroid/airless,
/area/ruin/space/has_grav)
"j" = (
/obj/effect/overlay/coconut,
/turf/open/floor/plating/asteroid/airless,
/area/ruin/space/has_grav)
"k" = (
/obj/effect/overlay/palmtree_l,
/turf/open/floor/plating/asteroid/airless,
/area/ruin/space/has_grav)
"l" = (
/obj/structure/flora/ausbushes/stalkybush,
/turf/open/floor/plating/asteroid/airless,
/area/ruin/space/has_grav)
"m" = (
/obj/structure/flora/ausbushes/grassybush,
/turf/open/floor/plating/asteroid/airless,
/area/ruin/space/has_grav)
"n" = (
/obj/structure/flora/ausbushes/reedbush,
/turf/open/floor/plating/asteroid/airless,
/area/ruin/space/has_grav)
"o" = (
/obj/structure/flora/ausbushes/lavendergrass,
/turf/open/floor/plating/asteroid/airless,
/area/ruin/space/has_grav)
"p" = (
/obj/structure/flora/ausbushes/brflowers,
/turf/open/floor/plating/asteroid/airless,
/area/ruin/space/has_grav)
"q" = (
/obj/structure/flora/ausbushes/fernybush,
/turf/open/floor/plating/asteroid/airless,
/area/ruin/space/has_grav)
"r" = (
/obj/effect/overlay/palmtree_r,
/turf/open/floor/plating/asteroid/airless,
/area/ruin/space/has_grav)
"s" = (
/obj/structure/flora/junglebush/large,
/turf/open/floor/plating/asteroid/airless,
/area/ruin/space/has_grav)
"t" = (
/obj/structure/flora/ausbushes/sunnybush,
/turf/open/floor/plating/asteroid/airless,
/area/ruin/space/has_grav)
"u" = (
/obj/machinery/door/airlock/survival_pod/glass{
	dir = 4
	},
/obj/effect/mapping_helpers/airlock/cyclelink_helper,
/turf/open/floor/plating/asteroid/airless,
/area/ruin/space/has_grav)
"T" = (
/obj/machinery/door/airlock/survival_pod/glass{
	dir = 4
	},
/obj/effect/mapping_helpers/airlock/cyclelink_helper{
	dir = 1
	},
/turf/open/floor/plating/asteroid/airless,
/area/ruin/space/has_grav)

(1,1,1) = {"
a
a
a
a
a
a
a
a
a
a
a
a
a
a
a
a
a
a
a
a
a
a
a
a
a
a
b
b
b
b
b
b
a
a
a
"}
(2,1,1) = {"
a
a
a
a
b
b
a
a
a
a
a
a
a
a
a
a
a
a
a
a
a
a
a
a
b
b
b
b
b
b
b
b
b
a
a
"}
(3,1,1) = {"
a
a
b
b
b
b
b
a
a
a
a
a
a
a
a
a
a
a
a
b
b
b
b
b
b
b
b
b
b
b
b
b
b
b
c
"}
(4,1,1) = {"
a
b
b
b
b
a
a
a
a
a
a
a
a
a
a
b
b
b
b
b
b
b
b
b
b
b
b
b
b
c
b
b
b
b
b
"}
(5,1,1) = {"
a
b
b
b
a
a
a
a
a
a
a
a
a
a
b
b
b
b
b
b
b
b
b
b
b
c
c
c
c
c
c
c
b
b
b
"}
(6,1,1) = {"
a
a
a
a
a
a
a
a
a
b
b
b
b
b
b
b
b
b
b
b
b
b
b
c
c
c
c
f
c
c
c
h
c
b
b
"}
(7,1,1) = {"
a
a
a
a
a
a
a
a
b
b
b
b
b
b
b
b
b
b
b
b
b
c
c
c
c
o
c
r
c
b
b
b
b
b
c
"}
(8,1,1) = {"
a
a
a
a
a
a
b
b
b
b
b
b
b
b
b
b
c
b
c
c
c
c
c
c
c
c
j
c
c
c
c
b
b
b
c
"}
(9,1,1) = {"
a
a
a
a
a
b
b
b
b
b
b
b
b
c
k
c
c
q
c
c
j
c
c
k
c
c
c
c
m
c
c
b
b
b
c
"}
(10,1,1) = {"
a
a
a
b
b
b
b
b
b
b
b
b
b
b
b
c
c
c
c
c
s
c
c
c
c
c
c
i
c
c
c
b
b
b
c
"}
(11,1,1) = {"
a
a
b
b
b
b
b
b
b
b
b
b
b
b
c
i
n
f
c
c
d
c
c
j
c
h
c
l
c
d
c
b
b
b
c
"}
(12,1,1) = {"
a
a
b
b
b
b
b
b
b
b
b
b
c
c
c
c
o
o
c
h
c
c
c
c
c
c
c
i
o
c
c
b
b
b
c
"}
(13,1,1) = {"
a
b
b
b
b
b
b
b
b
b
b
b
c
c
c
c
i
c
q
c
c
c
c
c
c
s
c
c
c
c
b
b
b
b
c
"}
(14,1,1) = {"
a
b
b
b
b
b
b
b
b
b
b
h
c
c
c
c
l
c
c
c
m
i
c
c
c
c
c
c
c
b
b
b
b
b
c
"}
(15,1,1) = {"
a
b
b
b
b
b
b
b
b
b
b
b
b
b
b
c
c
c
c
c
i
o
c
c
c
c
c
c
c
c
b
b
b
b
c
"}
(16,1,1) = {"
a
b
b
b
b
b
b
b
b
b
b
b
b
b
b
b
b
c
c
c
o
p
c
c
c
c
r
c
c
c
c
b
b
b
c
"}
(17,1,1) = {"
a
b
b
b
b
b
b
b
b
b
b
b
b
b
b
b
b
b
c
e
n
c
c
c
c
c
c
c
c
c
c
c
b
b
c
"}
(18,1,1) = {"
a
b
b
b
b
b
b
b
b
b
c
e
c
b
b
b
b
b
c
c
c
c
c
c
i
t
c
c
c
i
c
c
b
b
b
"}
(19,1,1) = {"
a
b
b
b
b
b
b
b
b
c
c
c
c
c
c
b
b
b
b
c
r
j
c
c
c
f
c
c
c
c
c
c
u
c
T
"}
(20,1,1) = {"
a
c
b
b
b
b
b
b
b
h
c
c
d
c
c
c
c
c
c
c
c
c
c
c
c
c
c
c
c
c
c
b
b
b
b
"}
(21,1,1) = {"
a
c
c
b
b
b
b
b
b
c
c
c
k
c
i
i
c
c
q
c
c
c
c
c
d
c
h
c
c
c
c
c
b
b
b
"}
(22,1,1) = {"
a
c
c
b
b
b
b
b
b
c
c
c
c
c
c
l
c
c
c
c
c
c
c
c
c
c
c
c
c
r
c
c
b
b
b
"}
(23,1,1) = {"
a
c
c
b
b
b
b
b
b
c
c
j
c
c
c
c
c
c
c
c
c
h
s
c
c
c
s
c
c
c
c
c
b
b
b
"}
(24,1,1) = {"
a
a
c
c
b
b
b
b
e
c
c
c
c
c
h
c
c
c
c
c
c
c
c
c
m
c
c
c
c
c
c
c
b
b
b
"}
(25,1,1) = {"
a
a
c
c
b
b
b
c
c
c
c
c
c
c
c
c
i
l
c
c
c
c
c
c
n
m
c
c
c
c
c
b
b
b
a
"}
(26,1,1) = {"
a
a
c
c
b
b
b
c
c
c
c
c
c
c
c
m
p
i
c
f
c
c
c
c
c
c
k
c
c
j
c
b
b
b
a
"}
(27,1,1) = {"
a
a
c
c
b
b
b
b
c
c
c
c
c
c
c
c
c
c
c
d
m
i
c
c
c
c
c
c
c
c
b
b
b
a
a
"}
(28,1,1) = {"
a
a
a
c
c
b
b
b
c
c
c
c
c
e
c
c
c
c
c
c
i
l
p
c
c
c
c
c
c
b
b
b
b
a
a
"}
(29,1,1) = {"
a
a
a
c
c
b
b
c
c
c
e
c
c
c
c
c
c
c
c
c
c
c
c
c
c
i
c
c
c
b
b
b
c
c
a
"}
(30,1,1) = {"
a
a
a
c
b
b
c
d
f
c
i
c
c
c
b
c
c
c
c
c
j
c
c
c
c
c
c
c
b
b
b
c
c
c
a
"}
(31,1,1) = {"
a
a
a
b
b
b
b
c
c
c
c
c
c
b
b
b
c
c
c
r
c
c
c
c
c
c
b
b
b
b
c
c
c
b
b
"}
(32,1,1) = {"
a
a
a
b
b
b
c
c
c
c
c
c
b
b
b
b
b
b
b
b
b
b
b
b
b
b
b
b
b
b
c
c
b
b
b
"}
(33,1,1) = {"
a
a
a
b
b
c
c
c
c
b
b
b
b
b
b
b
b
b
b
b
b
b
b
b
b
b
b
b
b
a
a
b
b
b
a
"}
(34,1,1) = {"
a
a
a
b
b
b
b
b
b
b
b
b
b
b
c
c
c
c
c
b
b
b
b
b
a
a
a
a
a
a
a
b
b
b
a
"}
(35,1,1) = {"
a
a
a
a
b
b
b
b
b
b
b
b
b
a
a
a
a
a
a
a
a
a
a
a
a
a
a
a
a
a
a
a
a
a
a
"}
