//MAP CONVERTED BY dmm2tgm.py THIS HEADER COMMENT PREVENTS RECONVERSION, DO NOT REMOVE
"a" = (
/turf/open/space,
/area/space)
"b" = (
/obj/structure/lattice,
/turf/open/space,
/area/space/nearstation)
"c" = (
/obj/structure/lattice,
/turf/open/floor/plating/asteroid/airless,
/area/ruin/unpowered/no_grav)
"d" = (
/turf/open/floor/plating/asteroid/airless,
/area/ruin/unpowered/no_grav)
"e" = (
/obj/structure/lattice,
/turf/open/floor/plating/airless,
/area/ruin/unpowered/no_grav)
"f" = (
/turf/closed/wall,
/area/ruin/space/has_grav/powered/aesthetic)
"g" = (
/turf/closed/wall/rust,
/area/ruin/space/has_grav/powered/aesthetic)
"h" = (
/obj/effect/overlay/palmtree_r,
/turf/open/floor/holofloor/beach,
/area/ruin/space/has_grav/powered/aesthetic)
"i" = (
/obj/structure/piano,
/obj/structure/window{
	dir = 8
	},
/turf/open/floor/plasteel/vaporwave,
/area/ruin/space/has_grav/powered/aesthetic)
"j" = (
/obj/structure/chair/stool,
/obj/machinery/light/small{
	dir = 1
	},
/turf/open/floor/plasteel/vaporwave,
/area/ruin/space/has_grav/powered/aesthetic)
"k" = (
/turf/open/floor/plasteel/vaporwave,
/area/ruin/space/has_grav/powered/aesthetic)
"l" = (
/obj/structure/chair/comfy/black{
	dir = 4
	},
/turf/open/floor/plasteel/vaporwave,
/area/ruin/space/has_grav/powered/aesthetic)
"m" = (
/obj/structure/table/reinforced,
/obj/item/taperecorder,
/turf/open/floor/plasteel/vaporwave,
/area/ruin/space/has_grav/powered/aesthetic)
"n" = (
/obj/structure/chair/comfy/black{
	dir = 8
	},
/turf/open/floor/plasteel/vaporwave,
/area/ruin/space/has_grav/powered/aesthetic)
"o" = (
/obj/structure/window{
	dir = 4
	},
/turf/open/floor/plasteel/vaporwave,
/area/ruin/space/has_grav/powered/aesthetic)
"p" = (
/obj/effect/overlay/palmtree_l,
/turf/open/floor/holofloor/beach,
/area/ruin/space/has_grav/powered/aesthetic)
"q" = (
/turf/open/floor/holofloor/beach,
/area/ruin/space/has_grav/powered/aesthetic)
"r" = (
/obj/structure/window{
	dir = 8
	},
/turf/open/floor/plasteel/vaporwave,
/area/ruin/space/has_grav/powered/aesthetic)
"s" = (
/obj/structure/table/reinforced,
/obj/item/clothing/glasses/sunglasses/big{
	name = "aesthetic sunglasses"
	},
/turf/open/floor/plasteel/vaporwave,
/area/ruin/space/has_grav/powered/aesthetic)
"t" = (
/obj/item/instrument/eguitar,
/turf/open/floor/holofloor/beach,
/area/ruin/space/has_grav/powered/aesthetic)
"u" = (
/turf/open/floor/holofloor/beach/coast_t,
/area/ruin/space/has_grav/powered/aesthetic)
"v" = (
/obj/item/statuebust,
/turf/open/floor/plasteel/vaporwave,
/area/ruin/space/has_grav/powered/aesthetic)
"w" = (
/mob/living/simple_animal/butterfly,
/turf/open/floor/plasteel/vaporwave,
/area/ruin/space/has_grav/powered/aesthetic)
"x" = (
/obj/structure/closet/crate/bin,
/obj/item/tape/random,
/turf/open/floor/plating/asteroid/airless,
/area/ruin/unpowered/no_grav)
"y" = (
/turf/open/floor/holofloor/beach/coast_b,
/area/ruin/space/has_grav/powered/aesthetic)
"z" = (
/obj/structure/fans/tiny,
/obj/machinery/door/airlock/hatch,
/turf/open/floor/pod/dark,
/area/ruin/space/has_grav/powered/aesthetic)
"A" = (
/obj/effect/turf_decal/sand,
/obj/effect/turf_decal/sand/plating,
/turf/open/floor/plating{
	initial_gas_mix = "TEMP=2.7"
	},
/area/ruin/unpowered/no_grav)
"B" = (
/obj/effect/turf_decal/sand/plating,
/turf/open/floor/plating{
	initial_gas_mix = "TEMP=2.7"
	},
/area/ruin/unpowered/no_grav)
"C" = (
/obj/structure/statue/sandstone/venus{
	desc = "Ugh, this is merely an ugly amateurish replica of the other statue! The letters RIPGOAT are scribbled onto the base.";
	dir = 8
	},
/obj/effect/turf_decal/sand/plating,
/turf/open/floor/plating{
	initial_gas_mix = "TEMP=2.7"
	},
/area/ruin/unpowered/no_grav)
"D" = (
/obj/effect/turf_decal/sand,
/turf/open/floor/plasteel/airless{
	icon_state = "recharge_floor_asteroid"
	},
/area/ruin/unpowered/no_grav)
"E" = (
/obj/effect/turf_decal/sand,
/turf/open/floor/plasteel/airless,
/area/ruin/unpowered/no_grav)
"F" = (
/obj/structure/statue/sandstone/venus{
	dir = 4
	},
/obj/effect/turf_decal/sand/plating,
/turf/open/floor/plating{
	initial_gas_mix = "TEMP=2.7"
	},
/area/ruin/unpowered/no_grav)
"G" = (
/obj/effect/turf_decal/stripes/asteroid/line,
/obj/effect/turf_decal/sand/plating,
/turf/open/floor/plating{
	initial_gas_mix = "TEMP=2.7"
	},
/area/ruin/unpowered/no_grav)
"H" = (
/obj/effect/overlay/palmtree_l,
/turf/open/floor/plating/asteroid/airless,
/area/ruin/unpowered/no_grav)
"I" = (
/obj/effect/turf_decal/sand,
/obj/effect/turf_decal/sand,
/turf/open/floor/plasteel/airless,
/area/ruin/unpowered/no_grav)
"J" = (
/obj/effect/turf_decal/sand,
/turf/open/floor/plasteel/airless{
	icon_state = "stairs-l"
	},
/area/ruin/unpowered/no_grav)
"K" = (
/obj/effect/turf_decal/sand,
/turf/open/floor/plasteel/airless{
	icon_state = "stairs-m"
	},
/area/ruin/unpowered/no_grav)
"L" = (
/obj/effect/turf_decal/sand,
/turf/open/floor/plasteel/airless{
	icon_state = "stairs-r"
	},
/area/ruin/unpowered/no_grav)
"M" = (
/obj/effect/overlay/palmtree_r,
/turf/open/floor/plating/asteroid/airless,
/area/ruin/unpowered/no_grav)
"O" = (
/obj/structure/chair/comfy/black{
	dir = 8
	},
/obj/machinery/light/small{
	dir = 1
	},
/turf/open/floor/plasteel/vaporwave,
/area/ruin/space/has_grav/powered/aesthetic)
"P" = (
/obj/machinery/light/small,
/turf/open/floor/plasteel/vaporwave,
/area/ruin/space/has_grav/powered/aesthetic)
"R" = (
/obj/machinery/light/small{
	dir = 1
	},
/obj/effect/turf_decal/sand/plating,
/turf/open/floor/plating{
	initial_gas_mix = "TEMP=2.7"
	},
/area/ruin/unpowered/no_grav)

(1,1,1) = {"
a
a
a
a
a
a
b
a
a
a
a
a
a
a
a
"}
(2,1,1) = {"
a
a
a
a
a
d
c
d
a
b
a
a
a
a
a
"}
(3,1,1) = {"
a
a
a
a
d
d
c
d
d
c
d
d
a
a
a
"}
(4,1,1) = {"
a
a
a
d
d
d
e
c
d
e
d
d
d
a
a
"}
(5,1,1) = {"
a
a
a
d
f
f
g
g
g
f
g
A
d
d
a
"}
(6,1,1) = {"
a
a
c
d
f
h
q
h
u
y
f
R
d
d
a
"}
(7,1,1) = {"
a
b
c
e
g
i
r
r
r
r
f
B
H
d
d
"}
(8,1,1) = {"
a
a
d
d
f
j
k
k
v
P
f
C
I
A
d
"}
(9,1,1) = {"
a
a
d
d
f
k
k
k
k
k
f
D
J
I
d
"}
(10,1,1) = {"
a
a
d
c
f
l
l
k
k
k
z
E
K
E
I
"}
(11,1,1) = {"
a
a
d
c
g
m
s
k
k
k
f
D
L
E
I
"}
(12,1,1) = {"
a
a
d
c
g
O
n
k
w
P
g
F
I
A
A
"}
(13,1,1) = {"
b
b
c
e
f
o
o
o
o
o
f
G
M
d
d
"}
(14,1,1) = {"
a
a
d
d
g
p
t
p
u
y
g
R
d
d
a
"}
(15,1,1) = {"
a
a
d
d
f
f
g
f
g
g
g
A
d
d
a
"}
(16,1,1) = {"
a
a
a
d
d
d
e
c
x
e
d
d
d
a
a
"}
(17,1,1) = {"
a
a
a
a
a
d
c
d
d
c
d
d
d
a
a
"}
(18,1,1) = {"
a
a
a
a
a
a
b
d
d
d
d
a
a
a
a
"}
(19,1,1) = {"
a
a
a
a
a
a
b
a
a
a
a
a
a
a
a
"}
