//MAP CONVERTED BY dmm2tgm.py THIS HEADER COMMENT PREVENTS RECONVERSION, DO NOT REMOVE
"a" = (
/turf/template_noop,
/area/template_noop)
"b" = (
/turf/closed/mineral/random,
/area/ruin/space/way_home)
"c" = (
/turf/open/floor/plating/asteroid/airless,
/area/ruin/space/way_home)
"d" = (
/obj/structure/signpost/salvation,
/turf/open/floor/plating/asteroid/airless,
/area/ruin/space/way_home)

(1,1,1) = {"
a
a
a
a
a
a
a
a
a
a
a
a
a
a
a
a
a
a
a
a
a
a
b
b
a
"}
(2,1,1) = {"
a
a
a
a
a
a
a
a
a
a
a
a
a
a
a
a
a
a
a
a
a
a
b
b
b
"}
(3,1,1) = {"
a
a
a
a
a
a
a
a
a
a
a
a
a
a
a
a
a
a
a
a
a
a
a
b
a
"}
(4,1,1) = {"
a
a
a
a
a
a
a
a
a
a
a
a
a
a
a
a
a
a
a
a
a
a
a
a
a
"}
(5,1,1) = {"
a
a
a
a
a
a
a
a
a
a
b
b
a
a
a
a
a
a
a
a
a
a
a
a
a
"}
(6,1,1) = {"
a
a
a
a
a
a
a
a
b
b
b
b
b
b
a
a
a
a
a
a
a
a
a
a
a
"}
(7,1,1) = {"
a
a
a
a
a
a
a
b
b
b
b
b
b
b
a
a
a
a
a
a
a
a
a
a
a
"}
(8,1,1) = {"
a
a
a
a
a
b
b
b
b
b
b
b
b
a
a
a
a
a
a
a
a
a
a
a
a
"}
(9,1,1) = {"
a
a
b
a
b
b
b
b
b
b
b
b
c
a
a
a
a
a
a
a
a
a
a
a
a
"}
(10,1,1) = {"
a
a
b
b
b
b
b
b
b
b
b
b
c
c
a
a
a
a
a
a
a
a
a
a
a
"}
(11,1,1) = {"
a
a
b
b
b
b
b
b
b
b
b
c
c
c
a
a
a
a
a
a
a
a
a
a
a
"}
(12,1,1) = {"
a
b
b
b
b
b
b
b
b
b
b
c
c
c
c
c
c
a
a
a
a
a
a
a
a
"}
(13,1,1) = {"
b
b
b
b
b
b
b
b
b
c
c
c
c
c
c
c
c
c
c
a
a
a
a
a
b
"}
(14,1,1) = {"
a
b
b
b
b
b
b
b
c
c
c
a
a
c
c
d
c
c
c
c
c
c
a
b
b
"}
(15,1,1) = {"
a
a
b
b
b
b
b
b
b
c
a
a
a
a
c
c
c
c
c
c
b
b
b
b
a
"}
(16,1,1) = {"
a
a
b
b
b
b
b
b
b
a
a
a
a
a
a
c
c
c
b
b
b
b
b
b
a
"}
(17,1,1) = {"
a
a
b
b
a
a
b
b
b
a
a
a
a
a
a
a
c
c
c
b
b
b
b
b
a
"}
(18,1,1) = {"
a
a
a
a
a
a
a
b
a
a
a
a
a
a
a
a
a
c
c
c
b
b
b
b
b
"}
(19,1,1) = {"
a
a
a
a
a
a
a
a
a
a
a
a
a
a
a
a
a
a
a
c
b
b
b
b
b
"}
(20,1,1) = {"
a
a
a
a
a
a
a
a
a
a
a
a
a
a
a
a
a
a
a
a
a
b
b
b
b
"}
(21,1,1) = {"
a
a
a
a
a
a
a
a
a
a
a
a
a
a
a
a
a
a
a
a
a
a
b
b
a
"}
(22,1,1) = {"
a
a
a
a
a
a
a
a
a
a
a
a
a
a
a
a
a
a
a
a
a
a
a
b
b
"}
