//MAP CONVERTED BY dmm2tgm.py THIS HEADER COMMENT PREVENTS RECONVERSION, DO NOT REMOVE
"b" = (
/obj/machinery/porta_turret/syndicate/pod,
/turf/closed/wall/mineral/plastitanium,
/area/shuttle/assault_pod)
"c" = (
/obj/structure/chair/comfy/shuttle{
	dir = 4
	},
/turf/open/floor/mineral/plastitanium/red,
/area/shuttle/assault_pod)
"d" = (
/turf/closed/wall/mineral/plastitanium,
/area/shuttle/assault_pod)
"e" = (
/obj/machinery/door/airlock/centcom{
	aiControlDisabled = 1;
	name = "Assault Pod";
	req_access_txt = "150"
	},
/obj/docking_port/mobile/assault_pod{
	name = "steel rain";
	port_direction = 4;
	preferred_direction = 4
	},
/turf/open/floor/plating,
/area/shuttle/assault_pod)
"h" = (
/obj/machinery/computer/shuttle/syndicate/drop_pod,
/turf/closed/wall/mineral/plastitanium,
/area/shuttle/assault_pod)
"p" = (
/turf/open/floor/mineral/plastitanium/red,
/area/shuttle/assault_pod)
"t" = (
/obj/machinery/door/airlock/centcom{
	aiControlDisabled = 1;
	name = "Assault Pod";
	req_access_txt = "150"
	},
/turf/open/floor/plating,
/area/shuttle/assault_pod)
"D" = (
/obj/structure/chair/comfy/shuttle,
/obj/machinery/light{
	dir = 1
	},
/turf/open/floor/mineral/plastitanium/red,
/area/shuttle/assault_pod)
"H" = (
/obj/structure/chair/comfy/shuttle{
	dir = 8
	},
/turf/open/floor/mineral/plastitanium/red,
/area/shuttle/assault_pod)
"L" = (
/obj/structure/chair/comfy/shuttle{
	dir = 1
	},
/obj/machinery/light,
/turf/open/floor/mineral/plastitanium/red,
/area/shuttle/assault_pod)
"R" = (
/obj/machinery/door/airlock/centcom{
	name = "Assault Pod";
	req_access_txt = "150"
	},
/turf/open/floor/plating,
/area/shuttle/assault_pod)
"V" = (
/turf/template_noop,
/area/template_noop)

(1,1,1) = {"
V
b
d
t
d
b
V
"}
(2,1,1) = {"
b
d
c
p
c
d
b
"}
(3,1,1) = {"
d
c
p
H
p
c
d
"}
(4,1,1) = {"
R
p
L
h
D
p
e
"}
(5,1,1) = {"
d
H
p
c
p
H
d
"}
(6,1,1) = {"
b
d
H
p
H
d
b
"}
(7,1,1) = {"
V
b
d
t
d
b
V
"}
