//MAP CONVERTED BY dmm2tgm.py THIS HEADER COMMENT PREVENTS RECONVERSION, DO NOT REMOVE
"a" = (
/turf/closed/wall/mineral/titanium,
/area/shuttle/supply)
"b" = (
/obj/effect/decal/cleanable/dirt,
/obj/effect/turf_decal/stripes/line{
	dir = 9
	},
/turf/open/floor/plasteel,
/area/shuttle/supply)
"c" = (
/obj/effect/turf_decal/stripes/line{
	dir = 1
	},
/turf/open/floor/plasteel,
/area/shuttle/supply)
"d" = (
/obj/effect/decal/cleanable/dirt,
/obj/effect/turf_decal/stripes/line{
	dir = 1
	},
/obj/machinery/light/small{
	dir = 1
	},
/turf/open/floor/plasteel,
/area/shuttle/supply)
"e" = (
/obj/effect/decal/cleanable/dirt,
/obj/effect/turf_decal/stripes/line{
	dir = 1
	},
/turf/open/floor/plasteel,
/area/shuttle/supply)
"f" = (
/obj/effect/turf_decal/stripes/line{
	dir = 5
	},
/turf/open/floor/plasteel,
/area/shuttle/supply)
"g" = (
/obj/effect/decal/cleanable/dirt,
/obj/effect/turf_decal/stripes/line{
	dir = 8
	},
/turf/open/floor/plasteel,
/area/shuttle/supply)
"h" = (
/obj/effect/turf_decal/bot,
/turf/open/floor/plasteel,
/area/shuttle/supply)
"i" = (
/obj/effect/decal/cleanable/dirt,
/obj/effect/turf_decal/bot,
/turf/open/floor/plasteel,
/area/shuttle/supply)
"j" = (
/obj/effect/decal/cleanable/dirt,
/obj/effect/turf_decal/stripes/line{
	dir = 4
	},
/turf/open/floor/plasteel,
/area/shuttle/supply)
"k" = (
/obj/machinery/conveyor{
	dir = 8;
	id = "cargounload"
	},
/obj/machinery/door/poddoor{
	id = "cargounload";
	name = "supply dock unloading door"
	},
/turf/open/floor/plating,
/area/shuttle/supply)
"l" = (
/obj/effect/decal/cleanable/oil,
/obj/effect/turf_decal/bot,
/turf/open/floor/plasteel,
/area/shuttle/supply)
"m" = (
/obj/effect/turf_decal/stripes/line{
	dir = 4
	},
/turf/open/floor/plasteel,
/area/shuttle/supply)
"n" = (
/obj/machinery/door/airlock/shuttle{
	name = "Supply Shuttle Airlock";
	req_access_txt = "31"
	},
/obj/effect/decal/cleanable/dirt,
/obj/docking_port/mobile/supply{
	dir = 4;
	dwidth = 4
	},
/turf/open/floor/plating,
/area/shuttle/supply)
"o" = (
/obj/effect/turf_decal/stripes/line{
	dir = 8
	},
/turf/open/floor/plasteel,
/area/shuttle/supply)
"p" = (
/obj/machinery/button/door{
	id = "cargounload";
	name = "Loading Doors";
	pixel_x = -24;
	pixel_y = 8
	},
/obj/machinery/button/door{
	id = "cargoload";
	name = "Loading Doors";
	pixel_x = -24;
	pixel_y = -8
	},
/obj/effect/turf_decal/stripes/line{
	dir = 8
	},
/obj/machinery/light{
	dir = 8
	},
/turf/open/floor/plasteel,
/area/shuttle/supply)
"q" = (
/obj/effect/turf_decal/stripes/line{
	dir = 4
	},
/obj/machinery/light{
	dir = 4
	},
/turf/open/floor/plasteel,
/area/shuttle/supply)
"r" = (
/obj/machinery/door/airlock/shuttle{
	name = "Supply Shuttle Airlock";
	req_access_txt = "31"
	},
/obj/effect/decal/cleanable/dirt,
/turf/open/floor/plating,
/area/shuttle/supply)
"s" = (
/obj/machinery/door/poddoor{
	id = "cargoload";
	name = "supply dock loading door"
	},
/obj/machinery/conveyor{
	dir = 4;
	id = "cargoload"
	},
/turf/open/floor/plating,
/area/shuttle/supply)
"t" = (
/obj/effect/decal/cleanable/dirt,
/obj/effect/turf_decal/stripes/line{
	dir = 10
	},
/turf/open/floor/plasteel,
/area/shuttle/supply)
"u" = (
/obj/effect/decal/cleanable/dirt,
/obj/effect/turf_decal/stripes/line,
/turf/open/floor/plasteel,
/area/shuttle/supply)
"v" = (
/obj/effect/turf_decal/stripes/line,
/turf/open/floor/plasteel,
/area/shuttle/supply)
"w" = (
/obj/effect/turf_decal/stripes/line{
	dir = 6
	},
/turf/open/floor/plasteel,
/area/shuttle/supply)
"x" = (
/obj/effect/decal/cleanable/dirt,
/obj/effect/turf_decal/delivery,
/turf/open/floor/plasteel,
/area/shuttle/supply)
"y" = (
/obj/effect/turf_decal/delivery,
/turf/open/floor/plasteel,
/area/shuttle/supply)
"z" = (
/obj/structure/window/reinforced{
	dir = 1
	},
/obj/structure/shuttle/engine/heater,
/obj/effect/turf_decal/stripes/line,
/turf/open/floor/plating/airless,
/area/shuttle/supply)
"A" = (
/obj/structure/window/reinforced{
	dir = 1
	},
/obj/structure/shuttle/engine/heater,
/obj/effect/decal/cleanable/dirt,
/obj/effect/turf_decal/stripes/line,
/turf/open/floor/plating/airless,
/area/shuttle/supply)
"B" = (
/turf/template_noop,
/area/template_noop)
"C" = (
/obj/structure/shuttle/engine/propulsion/burst/left,
/obj/effect/turf_decal/stripes/line,
/turf/open/floor/plating/airless,
/area/shuttle/supply)
"D" = (
/obj/structure/shuttle/engine/propulsion,
/obj/effect/turf_decal/stripes/line,
/turf/open/floor/plating/airless,
/area/shuttle/supply)
"E" = (
/obj/structure/shuttle/engine/propulsion/burst/right,
/obj/effect/turf_decal/stripes/line,
/turf/open/floor/plating/airless,
/area/shuttle/supply)

(1,1,1) = {"
a
a
a
k
n
a
r
s
a
a
a
B
"}
(2,1,1) = {"
a
b
g
g
o
p
o
o
t
a
a
C
"}
(3,1,1) = {"
a
c
h
l
h
h
h
i
u
x
z
D
"}
(4,1,1) = {"
a
d
i
i
i
h
i
h
v
x
A
D
"}
(5,1,1) = {"
a
e
i
h
h
h
h
h
v
y
A
D
"}
(6,1,1) = {"
a
f
j
m
j
q
m
j
w
a
a
E
"}
(7,1,1) = {"
a
a
a
a
a
a
a
a
a
a
a
B
"}
