//MAP CONVERTED BY dmm2tgm.py THIS HEADER COMMENT PREVENTS RECONVERSION, DO NOT REMOVE
"a" = (
/turf/closed/indestructible/necropolis,
/area/shuttle_arena)
"b" = (
/turf/open/indestructible/necropolis/air,
/area/shuttle_arena)
"c" = (
/obj/effect/forcefield/arena_shuttle,
/turf/open/indestructible/necropolis/air,
/area/shuttle_arena)
"d" = (
/turf/open/lava/smooth,
/area/shuttle_arena)
"e" = (
/obj/effect/landmark/shuttle_arena_entrance,
/turf/open/indestructible/necropolis/air,
/area/shuttle_arena)
"f" = (
/turf/template_noop,
/area/template_noop)
"g" = (
/turf/closed/indestructible/necropolis,
/area/shuttle/escape/arena)
"h" = (
/turf/open/indestructible{
	icon_state = "cult"
	},
/area/shuttle/escape/arena)
"i" = (
/obj/structure/closet/crate/necropolis/dragon,
/turf/open/indestructible{
	icon_state = "cult"
	},
/area/shuttle/escape/arena)
"j" = (
/turf/open/indestructible/necropolis/air,
/area/shuttle/escape/arena)
"k" = (
/obj/structure/fluff/drake_statue,
/turf/open/indestructible{
	icon_state = "cult"
	},
/area/shuttle/escape/arena)
"l" = (
/obj/structure/closet/crate/necropolis/tendril,
/turf/open/indestructible/necropolis/air,
/area/shuttle/escape/arena)
"m" = (
/obj/structure/fluff/drake_statue,
/turf/open/indestructible/necropolis/air,
/area/shuttle/escape/arena)
"n" = (
/obj/effect/forcefield/arena_shuttle_entrance,
/turf/open/indestructible/necropolis/air,
/area/shuttle/escape/arena)
"o" = (
/obj/effect/forcefield/arena_shuttle_entrance,
/obj/docking_port/mobile/emergency{
	name = "The Arena"
	},
/turf/open/indestructible/necropolis/air,
/area/shuttle/escape/arena)
"p" = (
/obj/structure/healingfountain,
/turf/open/indestructible/necropolis/air,
/area/shuttle/escape/arena)
"z" = (
/obj/effect/landmark/shuttle_arena_safe,
/turf/open/indestructible/necropolis/air,
/area/shuttle/escape/arena)

(1,1,1) = {"
a
a
a
a
a
a
a
a
a
a
a
a
a
a
a
a
a
a
a
a
a
a
a
a
a
a
a
f
g
g
g
g
g
g
g
n
g
o
g
g
g
g
g
n
g
n
g
g
g
f
"}
(2,1,1) = {"
a
b
b
b
a
b
b
b
b
b
b
b
b
b
b
b
b
b
b
b
b
b
b
b
b
b
a
f
g
g
g
g
g
g
g
g
g
g
g
g
g
g
g
g
g
g
g
g
g
g
"}
(3,1,1) = {"
a
b
b
b
b
b
b
b
b
b
b
b
b
b
b
b
b
b
b
b
b
b
b
b
b
b
a
f
g
h
j
j
j
j
j
j
j
j
j
j
j
j
j
j
j
j
j
h
p
g
"}
(4,1,1) = {"
a
b
b
b
b
b
b
b
b
b
b
e
b
b
b
b
b
b
b
b
b
b
b
b
e
b
a
f
g
h
k
l
j
m
l
j
m
l
j
k
l
j
m
l
j
m
j
j
p
g
"}
(5,1,1) = {"
a
b
e
b
b
b
b
b
b
b
b
b
b
b
b
b
b
a
b
b
b
b
b
b
b
b
a
f
g
i
h
h
j
j
z
j
j
z
j
h
z
j
j
z
j
j
j
j
p
g
"}
(6,1,1) = {"
a
a
b
b
a
b
b
b
b
b
b
b
b
b
b
b
b
a
b
b
b
b
b
b
b
b
a
f
g
i
i
h
j
j
j
j
j
j
j
j
j
j
j
j
j
j
j
j
p
g
"}
(7,1,1) = {"
a
b
b
b
b
b
b
b
b
a
b
d
d
d
b
b
b
a
a
b
b
e
b
b
b
b
a
f
g
i
i
h
j
j
j
j
j
j
j
j
j
j
j
j
j
j
j
j
p
g
"}
(8,1,1) = {"
a
b
b
b
b
b
b
b
b
b
b
d
d
d
d
b
b
b
b
b
b
b
b
b
b
b
a
f
g
i
h
h
j
j
z
j
j
z
j
j
z
j
h
z
j
j
j
j
p
g
"}
(9,1,1) = {"
a
b
b
b
b
b
b
b
b
b
b
d
d
d
d
d
b
b
b
b
b
b
b
b
b
b
a
f
g
h
k
l
j
m
l
j
m
l
j
m
l
j
m
l
j
m
j
j
p
g
"}
(10,1,1) = {"
a
b
b
b
b
b
b
b
b
b
b
b
b
b
b
b
b
b
b
b
b
b
b
b
b
b
a
f
g
h
j
j
j
j
j
j
j
j
j
j
j
j
j
j
j
j
j
h
g
g
"}
(11,1,1) = {"
a
b
b
b
b
b
b
b
b
b
b
b
b
b
b
b
b
b
b
b
b
b
b
b
b
b
a
f
g
g
g
g
g
g
g
g
g
g
g
g
g
g
g
g
g
g
g
g
g
f
"}
(12,1,1) = {"
a
b
b
b
b
b
b
b
b
b
b
b
b
b
b
b
b
b
b
b
b
b
b
b
b
b
a
f
f
f
f
f
f
f
f
f
f
f
f
f
f
f
f
f
f
f
f
f
f
f
"}
(13,1,1) = {"
a
b
b
b
b
b
b
b
b
b
b
b
b
b
b
b
b
b
b
b
b
b
b
b
b
d
a
a
a
a
a
a
a
a
a
a
a
a
a
a
a
a
a
a
a
a
a
a
a
a
"}
(14,1,1) = {"
a
b
b
b
b
b
a
b
b
b
e
b
b
a
b
b
b
b
b
b
b
b
b
b
d
d
d
b
a
b
b
b
b
b
b
b
b
b
b
b
b
b
b
b
b
b
b
b
b
a
"}
(15,1,1) = {"
a
b
b
b
b
b
b
b
b
b
b
b
b
a
b
b
b
b
b
b
b
b
b
b
d
d
b
b
a
b
b
b
b
b
b
b
b
b
b
b
b
b
b
b
b
b
b
b
b
a
"}
(16,1,1) = {"
a
b
e
b
b
b
b
b
b
b
b
b
b
b
b
b
b
b
b
b
b
b
d
d
d
d
b
b
a
b
b
b
b
b
b
b
b
e
b
b
b
b
b
b
b
b
b
b
b
a
"}
(17,1,1) = {"
a
b
b
b
b
b
b
b
b
b
b
b
b
b
b
b
e
b
b
b
b
b
d
d
b
b
b
b
a
b
b
b
b
b
b
b
b
b
b
b
b
b
b
b
b
b
b
b
b
a
"}
(18,1,1) = {"
a
a
a
a
b
b
b
b
b
b
b
b
b
b
b
b
b
b
b
b
b
b
b
b
b
b
b
b
a
b
b
b
b
b
b
b
b
b
b
b
b
b
b
b
b
b
b
b
b
a
"}
(19,1,1) = {"
a
a
a
a
a
b
b
b
b
b
b
b
b
b
b
b
b
b
b
b
b
b
b
b
b
b
b
b
b
b
b
b
b
b
b
b
b
b
b
b
b
b
b
b
b
b
b
b
b
a
"}
(20,1,1) = {"
a
a
a
a
a
b
b
b
b
b
b
b
b
b
b
b
b
b
b
b
b
b
b
b
b
b
b
b
b
b
b
b
b
b
b
b
b
b
b
b
b
a
b
b
a
a
b
b
b
a
"}
(21,1,1) = {"
a
c
b
b
b
b
b
b
b
b
b
b
b
b
b
b
b
b
b
b
b
b
b
b
b
b
b
b
b
b
b
b
b
b
b
d
d
b
b
b
b
a
b
b
b
a
b
b
b
a
"}
(22,1,1) = {"
a
c
b
b
b
b
b
b
b
b
d
d
b
b
b
b
b
b
b
d
d
b
b
b
b
b
b
b
b
b
b
b
b
b
d
d
b
b
b
b
b
a
b
b
b
a
b
b
b
a
"}
(23,1,1) = {"
a
c
b
b
b
b
b
b
b
b
d
d
d
b
b
b
b
b
b
d
d
b
b
b
b
b
b
b
e
b
b
b
b
b
d
b
b
b
b
b
b
a
b
e
b
a
b
b
b
a
"}
(24,1,1) = {"
a
c
b
b
b
b
b
b
b
b
b
b
d
d
b
b
b
b
b
d
d
b
b
b
b
b
b
b
b
b
b
b
b
b
d
b
b
b
b
b
b
a
b
b
b
a
b
b
b
a
"}
(25,1,1) = {"
a
a
a
a
a
b
b
b
b
b
b
b
b
d
b
b
b
b
b
d
d
b
b
b
b
b
b
b
b
b
b
b
b
b
d
b
b
b
b
b
b
a
a
a
a
a
b
b
b
a
"}
(26,1,1) = {"
a
a
a
a
a
b
b
b
b
b
b
b
b
b
b
b
b
b
b
b
b
b
b
b
b
b
b
b
b
b
b
b
b
d
d
d
b
b
b
b
b
b
b
b
b
b
b
b
e
a
"}
(27,1,1) = {"
a
a
a
a
b
b
b
b
e
b
b
b
b
b
b
b
b
b
b
b
b
b
b
b
b
a
a
b
b
b
b
b
b
d
d
d
b
b
b
b
b
b
b
b
b
b
b
b
b
a
"}
(28,1,1) = {"
a
b
b
b
b
b
b
b
b
b
b
b
b
b
b
b
b
b
b
b
b
b
b
b
b
a
a
b
b
b
b
b
b
d
d
d
b
b
b
b
b
b
b
b
b
b
b
b
b
a
"}
(29,1,1) = {"
a
b
b
b
b
b
b
b
b
b
b
b
b
b
b
b
b
b
b
b
b
b
b
b
b
a
a
b
b
b
b
b
b
b
b
b
b
b
b
b
b
b
b
b
b
b
b
b
b
a
"}
(30,1,1) = {"
a
b
b
b
b
b
b
b
a
b
b
b
b
b
b
b
b
b
b
a
a
a
a
a
a
a
a
b
b
b
b
b
b
b
b
b
b
b
b
b
b
b
b
b
b
b
b
b
b
a
"}
(31,1,1) = {"
a
b
b
b
b
b
b
b
a
b
b
b
b
b
b
b
b
b
b
b
b
b
b
b
b
a
a
b
b
b
b
b
b
b
b
b
b
b
b
b
b
b
b
b
b
b
b
b
b
a
"}
(32,1,1) = {"
a
b
b
b
b
b
b
b
b
b
b
b
b
b
b
b
b
b
e
b
b
b
b
b
b
b
b
b
b
b
b
b
b
b
b
b
b
b
b
e
b
b
b
b
b
b
b
b
b
a
"}
(33,1,1) = {"
a
b
b
b
b
b
b
b
b
b
b
b
b
b
b
b
b
b
b
b
b
b
b
b
b
b
b
b
e
b
b
b
b
b
b
b
b
b
b
b
b
b
b
b
b
b
b
b
b
a
"}
(34,1,1) = {"
a
b
b
b
b
b
b
b
b
b
b
b
b
b
b
b
b
b
b
b
b
b
b
b
b
b
b
b
b
b
b
b
b
b
b
b
b
b
b
b
b
b
b
b
b
b
b
b
b
a
"}
(35,1,1) = {"
a
b
b
e
b
b
b
b
b
b
b
b
a
a
a
a
a
b
b
b
b
b
b
b
b
b
b
b
b
b
b
b
b
b
b
a
a
a
a
a
a
a
a
b
b
b
b
b
b
a
"}
(36,1,1) = {"
a
b
b
b
b
b
b
b
b
b
b
b
a
a
a
a
a
b
b
b
b
b
b
b
b
b
b
b
b
b
b
b
b
b
b
b
b
b
b
b
a
b
b
b
b
b
b
b
b
a
"}
(37,1,1) = {"
a
b
b
b
b
b
b
b
b
b
b
b
b
b
b
b
b
b
b
b
b
b
b
b
b
b
b
b
b
b
b
b
b
b
b
b
b
a
b
b
a
b
b
b
b
b
b
b
b
a
"}
(38,1,1) = {"
a
b
b
b
b
b
b
b
b
b
b
b
b
b
b
b
b
b
b
b
b
b
b
b
b
b
b
b
b
b
b
b
b
b
b
b
b
a
b
e
a
b
b
b
b
b
b
b
b
a
"}
(39,1,1) = {"
a
b
b
b
b
b
b
b
b
b
b
b
b
b
b
b
b
b
b
b
b
b
e
b
b
b
b
b
b
b
b
b
b
b
b
b
b
a
a
a
a
b
b
b
b
b
b
b
b
a
"}
(40,1,1) = {"
a
b
b
b
b
b
b
b
b
b
b
b
b
b
b
b
b
b
b
b
b
b
b
b
b
b
b
b
b
b
b
b
b
b
b
b
b
b
b
b
a
b
b
b
b
b
b
b
b
a
"}
(41,1,1) = {"
a
b
b
b
a
a
a
a
a
b
b
b
b
b
b
b
b
b
b
b
b
b
b
b
b
b
b
b
b
b
d
d
d
d
d
b
b
b
b
b
a
b
b
b
b
b
b
b
e
a
"}
(42,1,1) = {"
a
b
b
b
b
b
b
b
a
b
b
b
b
b
b
b
b
b
b
b
b
b
b
b
b
b
b
b
b
b
d
d
d
d
d
b
b
b
b
b
b
b
b
b
b
b
b
b
b
a
"}
(43,1,1) = {"
a
b
b
b
b
b
b
b
a
b
b
b
b
b
b
b
b
b
b
b
b
b
b
b
b
b
b
b
b
b
d
d
d
d
d
b
b
b
b
b
b
b
b
b
b
b
b
b
b
a
"}
(44,1,1) = {"
a
b
b
b
b
b
b
b
a
b
b
b
b
b
b
b
e
b
b
b
b
b
b
b
b
b
a
a
a
a
d
d
d
d
d
b
b
b
b
b
b
b
b
b
b
b
a
b
b
a
"}
(45,1,1) = {"
a
b
b
b
b
e
b
b
a
b
b
b
b
b
b
b
b
b
b
b
b
b
b
b
b
b
a
e
b
b
d
d
d
d
d
b
b
b
b
b
b
b
b
b
b
b
a
b
b
a
"}
(46,1,1) = {"
a
b
b
b
b
b
b
b
a
b
b
b
b
b
b
b
b
b
b
b
b
b
b
b
b
b
b
b
b
b
d
d
d
d
d
d
d
d
b
b
b
b
b
b
b
b
a
b
b
a
"}
(47,1,1) = {"
a
b
b
b
b
b
b
b
b
b
b
b
b
b
b
b
b
b
b
b
b
b
b
d
d
d
d
d
d
d
d
d
d
d
d
d
d
d
b
b
b
b
b
e
b
b
b
b
b
a
"}
(48,1,1) = {"
a
d
d
b
b
b
b
b
b
b
b
b
b
b
b
b
b
b
b
b
b
b
b
d
d
d
d
d
d
d
d
d
d
d
d
d
d
d
d
d
b
b
b
b
b
b
b
b
b
a
"}
(49,1,1) = {"
a
d
d
b
b
b
b
b
b
b
b
b
b
b
b
b
b
b
b
b
b
b
b
d
d
d
d
d
d
d
d
d
d
d
d
d
d
d
d
d
b
b
b
b
b
b
b
b
b
a
"}
(50,1,1) = {"
a
a
a
a
a
a
a
a
a
a
a
a
a
a
a
a
a
a
a
a
a
a
a
a
a
a
a
a
a
a
a
a
a
a
a
a
a
a
a
a
a
a
a
a
a
a
a
a
a
a
"}
