//MAP CONVERTED BY dmm2tgm.py THIS HEADER COMMENT PREVENTS RECONVERSION, DO NOT REMOVE
"a" = (
/turf/template_noop,
/area/template_noop)
"b" = (
/obj/structure/shuttle/engine/propulsion{
	dir = 4
	},
/turf/open/floor/plating,
/area/shuttle/escape)
"c" = (
/obj/structure/shuttle/engine/heater{
	dir = 8
	},
/obj/structure/window/reinforced{
	dir = 1
	},
/turf/open/floor/plating,
/area/shuttle/escape)
"d" = (
/turf/closed/wall/mineral/titanium,
/area/shuttle/escape)
"f" = (
/obj/machinery/status_display/evac,
/turf/closed/wall/mineral/titanium,
/area/shuttle/escape)
"g" = (
/obj/machinery/door/airlock/titanium{
	name = "Emergency Shuttle Airlock"
	},
/turf/open/floor/plating,
/area/shuttle/escape)
"h" = (
/obj/machinery/door/airlock/titanium{
	name = "Emergency Shuttle Airlock"
	},
/obj/docking_port/mobile/emergency{
	dir = 2;
	name = "NES Port";
	width = 19
	},
/turf/open/floor/plating,
/area/shuttle/escape)
"l" = (
/obj/machinery/vending/wallmed,
/turf/closed/wall/mineral/titanium,
/area/shuttle/escape)
"m" = (
/obj/effect/spawner/structure/window/shuttle,
/turf/open/floor/plating,
/area/shuttle/escape)
"n" = (
/turf/open/floor/mineral/titanium/white,
/area/shuttle/escape)
"o" = (
/turf/open/floor/mineral/titanium/blue,
/area/shuttle/escape)
"p" = (
/obj/structure/shuttle/engine/heater{
	dir = 8
	},
/obj/structure/window/reinforced{
	dir = 4
	},
/turf/open/floor/plating,
/area/shuttle/escape)
"q" = (
/obj/machinery/stasis,
/turf/open/floor/mineral/titanium/white,
/area/shuttle/escape)
"r" = (
/turf/open/floor/mineral/titanium,
/area/shuttle/escape)
"s" = (
/obj/structure/chair/comfy/shuttle{
	dir = 4
	},
/turf/open/floor/mineral/titanium/blue,
/area/shuttle/escape)
"t" = (
/turf/closed/wall/mineral/titanium/interior,
/area/shuttle/escape)
"u" = (
/obj/structure/chair/comfy/brown{
	dir = 4
	},
/obj/machinery/light/small{
	dir = 1
	},
/turf/open/floor/mineral/titanium/yellow,
/area/shuttle/escape)
"v" = (
/obj/structure/table,
/obj/effect/spawner/lootdrop/maintenance,
/turf/open/floor/mineral/titanium/white,
/area/shuttle/escape)
"w" = (
/obj/machinery/door/airlock/public/glass{
	name = "Emergency Shuttle Infirmary"
	},
/turf/open/floor/mineral/titanium/white,
/area/shuttle/escape)
"y" = (
/obj/structure/table/reinforced,
/obj/item/storage/toolbox/emergency,
/obj/structure/window/reinforced{
	dir = 1
	},
/turf/open/floor/mineral/titanium/yellow,
/area/shuttle/escape)
"A" = (
/obj/structure/chair/comfy/brown{
	dir = 4
	},
/turf/open/floor/mineral/titanium/yellow,
/area/shuttle/escape)
"B" = (
/obj/structure/window/reinforced{
	dir = 4
	},
/obj/structure/window/reinforced{
	dir = 1
	},
/obj/structure/table/reinforced,
/obj/item/radio,
/turf/open/floor/mineral/titanium/yellow,
/area/shuttle/escape)
"D" = (
/obj/structure/chair/comfy/brown{
	dir = 4
	},
/obj/machinery/light/small,
/turf/open/floor/mineral/titanium/yellow,
/area/shuttle/escape)
"E" = (
/obj/machinery/door/airlock/public/glass{
	name = "Emergency Shuttle Cockpit";
	req_access_txt = "19"
	},
/turf/open/floor/mineral/titanium/yellow,
/area/shuttle/escape)
"F" = (
/turf/open/floor/mineral/titanium/yellow,
/area/shuttle/escape)
"G" = (
/obj/machinery/computer/emergency_shuttle{
	dir = 8
	},
/obj/structure/window/reinforced{
	dir = 4
	},
/turf/open/floor/mineral/titanium/yellow,
/area/shuttle/escape)
"H" = (
/obj/structure/chair/comfy/shuttle{
	dir = 4
	},
/turf/open/floor/mineral/plastitanium/red/brig,
/area/shuttle/escape)
"I" = (
/obj/structure/table/reinforced,
/obj/structure/window/reinforced{
	dir = 4
	},
/obj/structure/window/reinforced,
/obj/item/storage/firstaid/regular,
/turf/open/floor/mineral/titanium/yellow,
/area/shuttle/escape)
"J" = (
/turf/open/floor/mineral/plastitanium/red/brig,
/area/shuttle/escape)
"K" = (
/obj/machinery/door/airlock/public/glass{
	name = "Emergency Shuttle Brig";
	req_access_txt = "2"
	},
/turf/open/floor/mineral/plastitanium/red/brig,
/area/shuttle/escape)
"L" = (
/obj/structure/table/reinforced,
/obj/item/storage/firstaid/regular,
/obj/structure/window/reinforced,
/turf/open/floor/mineral/titanium/yellow,
/area/shuttle/escape)
"Q" = (
/obj/machinery/light,
/turf/open/floor/mineral/titanium,
/area/shuttle/escape)
"R" = (
/obj/machinery/light/small,
/turf/open/floor/mineral/titanium/white,
/area/shuttle/escape)
"S" = (
/obj/structure/chair/comfy/shuttle{
	dir = 4
	},
/obj/machinery/light{
	dir = 4
	},
/turf/open/floor/mineral/titanium/blue,
/area/shuttle/escape)
"T" = (
/obj/structure/chair/comfy/shuttle{
	dir = 4
	},
/obj/machinery/light/small{
	dir = 1
	},
/turf/open/floor/mineral/plastitanium/red/brig,
/area/shuttle/escape)
"V" = (
/obj/machinery/light{
	dir = 1
	},
/turf/open/floor/mineral/titanium,
/area/shuttle/escape)
"W" = (
/obj/structure/shuttle/engine/propulsion{
	dir = 4
	},
/obj/structure/window/reinforced{
	dir = 1
	},
/turf/open/floor/plating,
/area/shuttle/escape)
"X" = (
/obj/structure/shuttle/engine/propulsion{
	dir = 4
	},
/obj/structure/window/reinforced,
/turf/open/floor/plating,
/area/shuttle/escape)
"Y" = (
/obj/structure/shuttle/engine/heater{
	dir = 8
	},
/obj/structure/window/reinforced,
/turf/open/floor/plating,
/area/shuttle/escape)

(1,1,1) = {"
a
d
b
b
b
d
b
b
b
d
a
"}
(2,1,1) = {"
W
d
p
p
p
d
p
p
p
d
X
"}
(3,1,1) = {"
c
d
q
v
q
d
H
H
H
d
Y
"}
(4,1,1) = {"
d
l
n
n
R
d
T
J
H
l
d
"}
(5,1,1) = {"
d
d
d
w
f
l
f
K
d
d
d
"}
(6,1,1) = {"
a
d
s
r
s
s
s
r
s
d
a
"}
(7,1,1) = {"
a
m
s
r
s
s
s
r
s
m
a
"}
(8,1,1) = {"
d
d
s
Q
d
m
d
V
s
d
d
"}
(9,1,1) = {"
g
r
r
r
r
r
r
r
r
r
g
"}
(10,1,1) = {"
h
r
r
r
r
r
r
r
r
r
g
"}
(11,1,1) = {"
d
d
s
s
o
r
o
s
s
d
d
"}
(12,1,1) = {"
a
m
s
s
s
r
s
s
s
m
a
"}
(13,1,1) = {"
a
m
s
s
s
r
s
s
s
m
a
"}
(14,1,1) = {"
a
d
t
s
S
r
S
s
t
d
a
"}
(15,1,1) = {"
a
d
d
m
d
E
f
m
d
d
a
"}
(16,1,1) = {"
a
a
m
y
A
F
A
L
m
a
a
"}
(17,1,1) = {"
a
a
d
d
u
A
D
d
d
a
a
"}
(18,1,1) = {"
a
a
a
m
B
G
I
m
a
a
a
"}
(19,1,1) = {"
a
a
a
d
m
m
m
d
a
a
a
"}
