//MAP CONVERTED BY dmm2tgm.py THIS HEADER COMMENT PREVENTS RECONVERSION, DO NOT REMOVE
"a" = (
/turf/closed/wall/mineral/titanium,
/area/shuttle/escape)
"b" = (
/obj/effect/spawner/structure/window/shuttle,
/turf/open/floor/plating,
/area/shuttle/escape)
"c" = (
/obj/machinery/door/airlock/titanium{
	name = "Emergency Shuttle Airlock";
	req_access_txt = "2"
	},
/turf/open/floor/plating,
/area/shuttle/escape)
"d" = (
/turf/open/floor/plasteel/dark,
/area/shuttle/escape)
"e" = (
/obj/structure/chair/comfy/shuttle{
	dir = 1
	},
/turf/open/floor/plasteel/dark,
/area/shuttle/escape)
"f" = (
/obj/machinery/computer/emergency_shuttle{
	dir = 8
	},
/turf/open/floor/plasteel/dark,
/area/shuttle/escape)
"g" = (
/obj/structure/window/reinforced,
/obj/structure/table/reinforced,
/obj/item/storage/firstaid/regular,
/obj/item/book/manual/random,
/obj/structure/extinguisher_cabinet{
	pixel_x = -30
	},
/turf/open/floor/plasteel/dark,
/area/shuttle/escape)
"h" = (
/obj/machinery/door/window/southleft,
/turf/open/floor/plasteel/dark,
/area/shuttle/escape)
"i" = (
/obj/structure/table/reinforced,
/obj/structure/window/reinforced,
/obj/item/gps{
	gpstag = "STV5"
	},
/turf/open/floor/plasteel/dark,
/area/shuttle/escape)
"j" = (
/obj/machinery/status_display/evac,
/turf/closed/wall/mineral/titanium,
/area/shuttle/escape)
"k" = (
/obj/machinery/door/airlock/titanium{
	name = "Emergency Shuttle Airlock"
	},
/obj/docking_port/mobile/emergency{
	dwidth = 3;
	height = 5;
	name = "Secure Transport Vessel 5";
	width = 14
	},
/turf/open/floor/plating,
/area/shuttle/escape)
"l" = (
/turf/open/floor/plating,
/area/shuttle/escape)
"m" = (
/obj/structure/closet/emcloset,
/turf/open/floor/plating,
/area/shuttle/escape)
"n" = (
/obj/structure/chair/comfy/shuttle{
	dir = 4
	},
/turf/open/floor/plating,
/area/shuttle/escape)
"o" = (
/obj/structure/closet/crate,
/obj/effect/spawner/lootdrop/maintenance{
	lootcount = 8;
	name = "8maintenance loot spawner"
	},
/obj/effect/turf_decal/bot,
/turf/open/floor/plasteel,
/area/shuttle/escape)
"p" = (
/obj/structure/closet/crate/secure/loot,
/obj/effect/turf_decal/bot,
/turf/open/floor/plasteel,
/area/shuttle/escape)
"q" = (
/obj/machinery/door/airlock/titanium{
	name = "Emergency Shuttle Airlock"
	},
/turf/open/floor/plating,
/area/shuttle/escape)
"r" = (
/obj/structure/closet/crate/secure/weapon,
/obj/effect/spawner/lootdrop/armory_contraband,
/obj/effect/turf_decal/bot,
/obj/machinery/light{
	dir = 4
	},
/turf/open/floor/plasteel,
/area/shuttle/escape)
"s" = (
/obj/structure/chair/comfy/shuttle{
	dir = 4
	},
/obj/structure/extinguisher_cabinet{
	pixel_x = -30
	},
/turf/open/floor/plating,
/area/shuttle/escape)
"t" = (
/obj/structure/window/reinforced{
	dir = 1
	},
/obj/structure/shuttle/engine/heater,
/turf/open/floor/plating/airless,
/area/shuttle/escape)
"u" = (
/obj/structure/shuttle/engine/propulsion,
/turf/open/floor/plating/airless,
/area/shuttle/escape)
"v" = (
/obj/structure/closet/emcloset,
/obj/machinery/light{
	dir = 4
	},
/turf/open/floor/plating,
/area/shuttle/escape)
"w" = (
/obj/structure/closet/crate/secure/weapon,
/obj/effect/spawner/lootdrop/armory_contraband,
/obj/effect/turf_decal/bot,
/turf/open/floor/plasteel,
/area/shuttle/escape)

(1,1,1) = {"
a
c
a
k
a
b
b
b
a
q
a
q
a
a
"}
(2,1,1) = {"
b
d
g
l
n
n
n
n
n
l
s
l
t
u
"}
(3,1,1) = {"
b
e
h
l
l
l
l
l
l
l
l
l
t
u
"}
(4,1,1) = {"
b
f
i
v
o
o
o
p
p
r
w
m
t
u
"}
(5,1,1) = {"
a
a
j
a
a
b
b
b
a
a
a
a
a
a
"}
