//MAP CONVERTED BY dmm2tgm.py THIS HEADER COMMENT PREVENTS RECONVERSION, DO NOT REMOVE
"a" = (
/turf/template_noop,
/area/template_noop)
"b" = (
/turf/closed/mineral,
/area/shuttle/escape/meteor)
"c" = (
/obj/structure/window/reinforced{
	dir = 1;
	layer = 2.9
	},
/turf/open/floor/plating/asteroid,
/area/shuttle/escape/meteor)
"d" = (
/turf/open/floor/plating/asteroid,
/area/shuttle/escape/meteor)
"e" = (
/obj/machinery/computer/emergency_shuttle{
	dir = 4;
	use_power = 0
	},
/turf/open/floor/plating/asteroid,
/area/shuttle/escape/meteor)
"f" = (
/mob/living/simple_animal/hostile/asteroid/goliath,
/turf/open/floor/plating/asteroid,
/area/shuttle/escape/meteor)
"g" = (
/obj/structure/mineral_door/iron,
/turf/open/floor/plating/asteroid,
/area/shuttle/escape/meteor)
"h" = (
/obj/item/pickaxe,
/turf/open/floor/plating/asteroid,
/area/shuttle/escape/meteor)
"i" = (
/obj/effect/station_crash,
/turf/open/floor/plating/asteroid,
/area/shuttle/escape/meteor)
"k" = (
/obj/structure/closet/crate,
/turf/open/floor/plating/asteroid,
/area/shuttle/escape/meteor)
"l" = (
/obj/machinery/power/smes,
/turf/open/floor/plating/asteroid,
/area/shuttle/escape/meteor)
"m" = (
/obj/structure/window/reinforced{
	dir = 1
	},
/obj/structure/shuttle/engine/heater,
/turf/open/floor/plating/airless,
/area/shuttle/escape/meteor)
"n" = (
/obj/structure/shuttle/engine/propulsion,
/turf/open/floor/plating/airless,
/area/shuttle/escape/meteor)
"u" = (
/obj/machinery/power/terminal{
	dir = 1
	},
/turf/open/floor/plating/asteroid,
/area/shuttle/escape/meteor)
"L" = (
/obj/docking_port/mobile/emergency{
	dwidth = 20;
	height = 40;
	movement_force = list("KNOCKDOWN" = 3, "THROW" = 6);
	name = "\proper a meteor with engines strapped to it";
	width = 40
	},
/turf/open/floor/plating/asteroid,
/area/shuttle/escape/meteor)

(1,1,1) = {"
a
a
a
b
b
b
b
b
b
b
b
d
d
d
b
b
b
d
d
d
L
d
d
b
d
d
d
d
d
b
b
b
b
b
b
b
b
a
a
a
"}
(2,1,1) = {"
a
a
b
b
b
b
d
d
b
b
b
b
b
b
b
d
d
d
b
i
b
b
b
b
b
b
b
d
d
d
d
d
b
b
b
b
b
b
a
a
"}
(3,1,1) = {"
a
b
b
b
b
d
d
d
b
b
b
b
d
d
d
d
b
b
b
b
b
b
b
b
b
b
b
b
d
d
d
d
d
d
b
b
b
b
a
a
"}
(4,1,1) = {"
b
b
b
b
b
d
d
d
b
b
b
b
d
d
d
b
b
b
b
b
b
b
b
b
b
b
b
b
b
b
d
d
d
d
b
b
b
b
b
a
"}
(5,1,1) = {"
b
b
b
b
b
b
d
b
b
b
b
b
b
d
d
b
b
b
b
b
b
b
d
d
d
d
k
b
b
b
b
b
b
b
b
b
b
b
b
a
"}
(6,1,1) = {"
b
b
b
b
b
b
d
b
b
b
b
b
b
d
d
b
b
b
b
b
b
d
d
d
d
d
k
b
b
b
b
b
b
b
b
b
b
b
b
b
"}
(7,1,1) = {"
b
b
b
b
b
b
d
b
b
b
b
b
b
d
d
b
b
b
b
b
b
d
d
d
d
b
k
b
b
b
b
b
b
b
b
b
b
b
b
b
"}
(8,1,1) = {"
b
b
b
b
b
b
d
b
b
b
b
b
b
d
d
b
b
b
b
b
b
d
b
b
b
b
b
b
b
b
b
b
b
b
b
b
b
b
a
a
"}
(9,1,1) = {"
b
b
b
b
b
b
d
b
b
b
b
b
b
g
g
b
b
b
b
b
b
d
b
b
b
b
b
b
b
b
b
b
b
b
b
b
b
b
a
a
"}
(10,1,1) = {"
a
b
b
b
b
b
d
b
b
b
b
b
d
d
d
b
b
b
b
b
b
d
b
b
b
b
b
b
b
b
b
b
b
b
b
b
b
b
a
a
"}
(11,1,1) = {"
a
b
b
b
b
d
d
d
d
d
d
d
d
d
d
b
b
b
b
b
b
d
b
b
b
b
b
b
b
b
b
b
b
b
b
b
b
b
a
a
"}
(12,1,1) = {"
a
b
b
b
b
b
d
d
d
d
d
d
d
d
d
d
d
d
d
d
d
d
d
d
d
b
b
b
b
b
b
b
b
b
b
b
b
b
a
a
"}
(13,1,1) = {"
b
b
b
b
b
b
b
b
b
b
b
b
b
b
b
b
b
b
b
b
b
d
b
b
b
b
b
b
b
b
b
b
b
b
b
b
b
b
a
a
"}
(14,1,1) = {"
b
b
b
b
b
b
b
b
b
b
b
b
b
b
b
b
b
b
b
b
b
d
b
b
b
b
b
b
b
b
b
b
b
b
b
b
b
b
b
b
"}
(15,1,1) = {"
b
b
b
b
b
b
b
b
b
b
b
b
b
b
b
b
b
b
b
b
b
d
b
b
b
b
b
b
b
b
b
b
b
b
b
b
b
b
b
b
"}
(16,1,1) = {"
b
b
b
b
b
b
b
b
b
b
b
b
b
b
b
b
b
b
b
b
b
d
b
b
b
b
b
b
b
b
b
b
b
b
b
b
b
b
b
a
"}
(17,1,1) = {"
a
c
d
e
b
b
b
b
b
b
b
b
b
b
b
b
b
b
b
b
b
d
b
b
b
b
b
b
b
b
b
b
b
b
b
b
b
b
b
a
"}
(18,1,1) = {"
a
c
d
d
b
b
b
b
b
b
b
b
b
b
b
b
b
b
b
b
b
d
b
b
b
b
b
b
b
b
b
b
b
b
b
b
b
b
b
b
"}
(19,1,1) = {"
a
c
d
d
d
d
d
d
d
b
b
b
b
b
b
b
b
b
b
b
b
d
b
b
b
b
b
b
b
b
b
b
b
b
b
d
d
d
m
n
"}
(20,1,1) = {"
a
c
d
d
b
b
b
b
d
b
b
b
b
d
d
d
d
d
d
d
d
d
d
d
d
d
d
d
d
d
d
d
d
d
d
d
d
d
m
n
"}
(21,1,1) = {"
a
c
d
d
b
b
b
b
d
b
b
b
d
d
b
b
b
b
b
b
b
d
b
b
b
b
b
b
d
b
b
b
b
b
b
d
d
d
m
n
"}
(22,1,1) = {"
b
b
b
b
b
b
b
b
d
d
d
d
d
d
b
b
b
b
b
b
b
b
b
b
b
b
b
b
d
b
b
b
b
b
b
d
d
d
m
n
"}
(23,1,1) = {"
b
b
b
b
b
b
b
d
d
d
d
d
d
d
b
b
b
b
b
b
b
b
b
b
b
b
b
b
d
b
b
b
b
b
b
b
b
b
b
a
"}
(24,1,1) = {"
b
b
b
b
b
b
b
d
d
b
b
b
d
d
b
b
b
b
b
b
b
b
b
b
b
b
b
b
d
b
b
b
b
b
b
b
b
b
b
a
"}
(25,1,1) = {"
b
b
b
b
b
b
b
d
d
b
b
b
d
d
b
b
b
b
b
b
b
b
b
b
b
b
b
b
d
b
b
b
b
b
b
b
b
b
b
a
"}
(26,1,1) = {"
b
b
b
b
b
b
b
d
d
b
b
b
d
d
b
b
b
b
b
b
b
b
b
b
b
b
b
b
d
b
b
b
b
b
b
b
b
b
b
a
"}
(27,1,1) = {"
a
b
b
b
b
b
b
d
d
b
b
b
d
d
b
b
b
b
b
b
b
b
b
b
b
b
b
b
d
b
b
b
b
b
b
b
b
b
b
a
"}
(28,1,1) = {"
b
b
b
b
b
b
b
b
b
b
b
b
b
b
b
d
b
b
b
b
b
d
d
d
d
d
d
d
d
b
b
b
b
b
b
b
b
b
b
a
"}
(29,1,1) = {"
b
b
b
b
b
b
b
b
b
b
b
b
b
b
b
d
d
d
d
b
b
b
d
b
b
b
b
b
d
b
b
b
b
b
b
b
b
b
b
a
"}
(30,1,1) = {"
b
b
b
b
b
b
b
b
b
b
b
b
b
b
b
d
b
b
d
b
b
b
d
b
b
b
b
b
d
b
b
b
b
b
b
b
b
b
b
a
"}
(31,1,1) = {"
b
b
b
b
b
b
b
b
b
b
b
b
b
b
b
d
b
b
d
b
b
b
d
b
b
b
b
b
d
b
b
b
b
b
b
b
b
b
a
a
"}
(32,1,1) = {"
a
b
b
b
b
b
b
b
b
b
b
b
b
b
b
d
b
b
d
b
b
b
d
b
b
b
l
u
d
d
d
d
b
b
b
b
b
b
a
a
"}
(33,1,1) = {"
a
b
b
b
b
b
b
b
b
b
b
b
b
b
b
d
b
b
h
b
b
b
d
b
b
b
l
u
d
d
d
d
b
b
b
b
b
b
a
a
"}
(34,1,1) = {"
a
b
b
b
b
b
b
d
d
d
b
b
b
b
b
d
b
b
b
b
b
b
d
b
b
b
l
u
d
d
d
d
b
b
b
b
b
m
n
a
"}
(35,1,1) = {"
a
b
b
b
b
b
d
d
f
d
b
b
b
b
d
d
d
d
d
d
d
d
d
b
b
b
l
u
d
d
d
d
b
b
b
b
b
m
n
a
"}
(36,1,1) = {"
a
b
b
b
b
b
d
d
d
d
b
b
b
b
b
b
b
b
b
b
b
b
b
b
b
b
l
u
d
d
d
d
d
d
d
d
d
m
n
a
"}
(37,1,1) = {"
a
b
b
b
b
b
b
b
b
b
b
b
b
b
b
b
b
b
b
b
b
b
b
b
b
b
l
u
d
d
d
d
b
b
b
b
b
m
n
a
"}
(38,1,1) = {"
a
b
b
b
b
b
b
b
b
b
b
b
b
b
b
b
b
b
b
b
b
b
b
b
b
b
b
b
b
b
b
b
b
b
b
b
b
b
b
a
"}
(39,1,1) = {"
a
a
b
b
b
b
b
b
b
b
b
b
b
a
a
b
b
b
b
b
b
b
b
b
b
b
b
b
b
b
b
b
b
b
b
b
b
b
a
a
"}
(40,1,1) = {"
a
a
a
a
a
a
b
b
b
b
b
b
b
a
a
b
b
b
b
b
a
a
b
a
a
a
a
b
b
b
b
b
b
b
b
b
b
a
a
a
"}
