//MAP CONVERTED BY dmm2tgm.py THIS HEADER COMMENT PREVENTS RECONVERSION, DO NOT REMOVE
"aa" = (
/turf/template_noop,
/area/template_noop)
"ab" = (
/turf/closed/wall,
/area/shuttle/escape)
"ac" = (
/obj/effect/spawner/structure/window/reinforced,
/turf/open/floor/plating,
/area/shuttle/escape)
"ad" = (
/turf/closed/wall/rust,
/area/shuttle/escape)
"ae" = (
/obj/structure/table,
/obj/item/storage/firstaid/fire,
/turf/open/floor/mineral/titanium/blue,
/area/shuttle/escape)
"af" = (
/obj/structure/chair/comfy/shuttle{
	dir = 1
	},
/turf/open/floor/mineral/titanium/blue,
/area/shuttle/escape)
"ag" = (
/obj/machinery/computer/emergency_shuttle,
/turf/open/floor/mineral/titanium/blue,
/area/shuttle/escape)
"ah" = (
/obj/structure/table,
/obj/item/storage/firstaid/regular{
	pixel_x = 2;
	pixel_y = 3
	},
/obj/item/crowbar,
/turf/open/floor/mineral/titanium/blue,
/area/shuttle/escape)
"ai" = (
/obj/machinery/computer/crew{
	dir = 4
	},
/turf/open/floor/mineral/titanium/blue,
/area/shuttle/escape)
"aj" = (
/obj/structure/chair/comfy/shuttle{
	dir = 8
	},
/turf/open/floor/mineral/titanium,
/area/shuttle/escape)
"ak" = (
/turf/open/floor/mineral/titanium,
/area/shuttle/escape)
"al" = (
/obj/effect/decal/cleanable/dirt,
/turf/open/floor/mineral/titanium,
/area/shuttle/escape)
"am" = (
/obj/structure/table,
/obj/item/storage/fancy/cigarettes/cigars/cohiba,
/obj/item/reagent_containers/food/drinks/bottle/vodka/badminka{
	pixel_x = 5;
	pixel_y = 18
	},
/turf/open/floor/mineral/titanium/blue,
/area/shuttle/escape)
"an" = (
/obj/machinery/computer/security{
	dir = 4
	},
/turf/open/floor/mineral/titanium/blue,
/area/shuttle/escape)
"ao" = (
/obj/machinery/button/flasher{
	id = "cockpit_flasher";
	pixel_x = 6;
	pixel_y = -24
	},
/obj/structure/chair/comfy/shuttle{
	dir = 8
	},
/turf/open/floor/mineral/titanium,
/area/shuttle/escape)
"ap" = (
/obj/item/radio/intercom{
	name = "Station Intercom (General)";
	pixel_y = -29
	},
/obj/effect/decal/cleanable/dirt,
/obj/machinery/light,
/turf/open/floor/mineral/titanium,
/area/shuttle/escape)
"aq" = (
/obj/structure/chair/comfy/shuttle,
/turf/open/floor/mineral/titanium,
/area/shuttle/escape)
"ar" = (
/obj/machinery/button/door{
	id = "ohnorevs";
	name = "window shutters";
	pixel_x = 26;
	pixel_y = -6;
	req_access_txt = "19"
	},
/obj/structure/chair/comfy/shuttle,
/obj/machinery/button/door{
	id = "bearsbearsbears";
	name = "release bears";
	pixel_x = 26;
	pixel_y = 6;
	req_access_txt = "20"
	},
/turf/open/floor/mineral/titanium/blue,
/area/shuttle/escape)
"as" = (
/obj/machinery/status_display/evac,
/turf/closed/wall/rust,
/area/shuttle/escape)
"at" = (
/obj/machinery/door/airlock/public/glass{
	name = "Glorious Leaders";
	req_access_txt = "19"
	},
/turf/open/floor/mineral/titanium,
/area/shuttle/escape)
"au" = (
/obj/effect/spawner/structure/window/reinforced,
/obj/machinery/door/poddoor/shutters/preopen{
	id = "ohnorevs"
	},
/turf/open/floor/plating,
/area/shuttle/escape)
"av" = (
/obj/structure/chair/comfy/shuttle,
/turf/open/floor/mineral/plastitanium/red/brig,
/area/shuttle/escape)
"aw" = (
/obj/machinery/flasher{
	id = "cockpit_flasher";
	pixel_x = 6;
	pixel_y = 24
	},
/turf/open/floor/mineral/plastitanium/red,
/area/shuttle/escape)
"ax" = (
/turf/open/floor/mineral/plastitanium/red,
/area/shuttle/escape)
"ay" = (
/obj/structure/window/reinforced{
	dir = 8
	},
/turf/open/floor/engine,
/area/shuttle/escape)
"az" = (
/obj/item/tank/internals/oxygen,
/turf/open/floor/engine,
/area/shuttle/escape)
"aA" = (
/turf/open/floor/engine,
/area/shuttle/escape)
"aB" = (
/obj/effect/decal/cleanable/dirt,
/turf/open/floor/engine,
/area/shuttle/escape)
"aC" = (
/obj/item/kitchen/knife,
/turf/open/floor/engine,
/area/shuttle/escape)
"aD" = (
/turf/closed/wall/r_wall,
/area/shuttle/escape)
"aE" = (
/turf/closed/wall/r_wall/rust,
/area/shuttle/escape)
"aF" = (
/obj/machinery/flasher{
	id = "shuttle_flasher";
	pixel_x = -24;
	pixel_y = 6
	},
/obj/machinery/button/flasher{
	id = "shuttle_flasher";
	pixel_x = -24;
	pixel_y = -6
	},
/obj/machinery/light/small{
	brightness = 3;
	dir = 8
	},
/turf/open/floor/mineral/plastitanium/red/brig,
/area/shuttle/escape)
"aG" = (
/obj/effect/decal/cleanable/dirt,
/turf/open/floor/mineral/plastitanium/red/brig,
/area/shuttle/escape)
"aH" = (
/turf/open/floor/mineral/plastitanium/red/brig,
/area/shuttle/escape)
"aI" = (
/obj/machinery/door/airlock/security/glass{
	name = "Emergency Shuttle Brig";
	req_access_txt = "2"
	},
/turf/open/floor/mineral/plastitanium,
/area/shuttle/escape)
"aJ" = (
/obj/structure/chair/comfy/shuttle{
	dir = 4
	},
/turf/open/floor/mineral/plastitanium,
/area/shuttle/escape)
"aK" = (
/obj/effect/decal/cleanable/blood/old,
/turf/open/floor/engine,
/area/shuttle/escape)
"aL" = (
/obj/effect/decal/cleanable/blood/old,
/obj/item/broken_bottle,
/turf/open/floor/engine,
/area/shuttle/escape)
"aM" = (
/obj/effect/decal/cleanable/robot_debris/old,
/obj/machinery/door/poddoor{
	id = "bearsbearsbears"
	},
/turf/open/floor/engine,
/area/shuttle/escape)
"aN" = (
/obj/effect/decal/cleanable/blood/old,
/mob/living/simple_animal/hostile/bear/fightpit,
/turf/open/floor/engine,
/area/shuttle/escape)
"aO" = (
/obj/machinery/door/airlock/security/glass{
	name = "Emergency Shuttle Airlock";
	req_access_txt = "2"
	},
/turf/open/floor/plating,
/area/shuttle/escape)
"aP" = (
/obj/structure/chair/comfy/shuttle{
	dir = 1
	},
/turf/open/floor/mineral/plastitanium/red/brig,
/area/shuttle/escape)
"aQ" = (
/obj/effect/decal/cleanable/robot_debris/old,
/turf/open/floor/engine,
/area/shuttle/escape)
"aR" = (
/obj/effect/decal/cleanable/dirt,
/turf/open/floor/mineral/plastitanium/red,
/area/shuttle/escape)
"aS" = (
/obj/structure/window/reinforced{
	dir = 8
	},
/obj/effect/decal/cleanable/dirt,
/turf/open/floor/engine,
/area/shuttle/escape)
"aT" = (
/obj/effect/decal/cleanable/vomit/old,
/turf/open/floor/engine,
/area/shuttle/escape)
"aU" = (
/obj/effect/decal/cleanable/blood/old,
/obj/machinery/door/poddoor{
	id = "bearsbearsbears"
	},
/turf/open/floor/engine,
/area/shuttle/escape)
"aV" = (
/obj/item/kitchen/fork,
/mob/living/simple_animal/hostile/bear/fightpit,
/turf/open/floor/engine,
/area/shuttle/escape)
"aW" = (
/obj/docking_port/mobile/emergency{
	height = 15;
	name = "Box emergency shuttle"
	},
/obj/machinery/door/airlock/security/glass{
	name = "Emergency Shuttle Airlock"
	},
/turf/open/floor/plating,
/area/shuttle/escape)
"aX" = (
/obj/structure/extinguisher_cabinet{
	pixel_x = -5;
	pixel_y = 30
	},
/turf/open/floor/mineral/plastitanium/red,
/area/shuttle/escape)
"aY" = (
/obj/structure/window/reinforced,
/obj/structure/window/reinforced{
	dir = 8
	},
/turf/open/floor/engine,
/area/shuttle/escape)
"aZ" = (
/obj/effect/decal/cleanable/shreds,
/obj/machinery/door/window{
	name = "fight pit"
	},
/turf/open/floor/engine,
/area/shuttle/escape)
"ba" = (
/obj/structure/window/reinforced,
/turf/open/floor/engine,
/area/shuttle/escape)
"bb" = (
/obj/effect/decal/cleanable/blood/old,
/obj/structure/window/reinforced,
/turf/open/floor/engine,
/area/shuttle/escape)
"bc" = (
/obj/structure/chair/comfy/shuttle{
	dir = 8
	},
/obj/structure/window/reinforced{
	dir = 4
	},
/turf/open/floor/mineral/plastitanium,
/area/shuttle/escape)
"bd" = (
/obj/structure/window/reinforced{
	dir = 8
	},
/obj/structure/chair/comfy/shuttle{
	dir = 4
	},
/turf/open/floor/mineral/plastitanium,
/area/shuttle/escape)
"be" = (
/obj/structure/table,
/obj/item/reagent_containers/food/drinks/bottle/vodka,
/turf/open/floor/mineral/plastitanium,
/area/shuttle/escape)
"bf" = (
/obj/structure/window/reinforced{
	dir = 4
	},
/obj/structure/chair/comfy/shuttle{
	dir = 1
	},
/turf/open/floor/mineral/plastitanium,
/area/shuttle/escape)
"bg" = (
/obj/structure/window/reinforced{
	dir = 8
	},
/obj/structure/chair/comfy/shuttle{
	dir = 1
	},
/turf/open/floor/mineral/plastitanium,
/area/shuttle/escape)
"bh" = (
/obj/structure/chair/comfy/shuttle{
	dir = 1
	},
/turf/open/floor/mineral/plastitanium,
/area/shuttle/escape)
"bi" = (
/obj/structure/table,
/obj/item/stack/medical/bruise_pack{
	pixel_x = 5;
	pixel_y = 5
	},
/obj/item/stack/medical/bruise_pack,
/turf/open/floor/mineral/plastitanium,
/area/shuttle/escape)
"bj" = (
/obj/effect/decal/cleanable/vomit/old,
/turf/open/floor/mineral/plastitanium/red,
/area/shuttle/escape)
"bk" = (
/obj/structure/kitchenspike,
/turf/open/floor/mineral/plastitanium,
/area/shuttle/escape)
"bl" = (
/obj/effect/decal/hammerandsickle,
/turf/open/floor/mineral/plastitanium/red,
/area/shuttle/escape)
"bm" = (
/obj/structure/table,
/obj/item/hatchet,
/turf/open/floor/mineral/plastitanium,
/area/shuttle/escape)
"bn" = (
/obj/structure/table,
/obj/item/clothing/gloves/boxing{
	pixel_x = 4;
	pixel_y = 7
	},
/obj/item/clothing/gloves/boxing,
/turf/open/floor/mineral/plastitanium,
/area/shuttle/escape)
"bo" = (
/obj/structure/table,
/obj/item/melee/baseball_bat{
	pixel_x = -5
	},
/obj/item/crowbar/large{
	pixel_x = 6
	},
/turf/open/floor/mineral/plastitanium,
/area/shuttle/escape)
"bp" = (
/obj/structure/table,
/obj/item/shovel,
/turf/open/floor/mineral/plastitanium,
/area/shuttle/escape)
"bq" = (
/obj/item/broken_bottle,
/obj/effect/decal/cleanable/blood/old,
/turf/open/floor/mineral/plastitanium/red,
/area/shuttle/escape)
"br" = (
/obj/machinery/door/airlock/security/glass{
	name = "Emergency Shuttle Airlock"
	},
/turf/open/floor/plating,
/area/shuttle/escape)
"bs" = (
/obj/structure/extinguisher_cabinet{
	pixel_y = -30
	},
/turf/open/floor/mineral/plastitanium/red,
/area/shuttle/escape)
"bt" = (
/obj/structure/extinguisher_cabinet{
	pixel_x = 27
	},
/obj/structure/table,
/obj/item/reagent_containers/food/drinks/bottle/vodka,
/turf/open/floor/mineral/plastitanium,
/area/shuttle/escape)
"bu" = (
/obj/machinery/door/airlock/security/glass{
	name = "Emergency Shuttle Cargo"
	},
/turf/open/floor/mineral/plastitanium,
/area/shuttle/escape)
"bv" = (
/obj/machinery/status_display/evac,
/turf/closed/wall,
/area/shuttle/escape)
"bw" = (
/obj/machinery/door/airlock/security/glass{
	name = "Emergency Shuttle Infirmary"
	},
/turf/open/floor/mineral/plastitanium,
/area/shuttle/escape)
"bx" = (
/turf/open/floor/plating,
/area/shuttle/escape)
"by" = (
/obj/effect/decal/cleanable/dirt,
/turf/open/floor/plating,
/area/shuttle/escape)
"bz" = (
/obj/structure/extinguisher_cabinet{
	pixel_x = 27
	},
/turf/open/floor/plating,
/area/shuttle/escape)
"bA" = (
/obj/structure/closet/emcloset,
/obj/effect/decal/cleanable/dirt,
/turf/open/floor/plasteel,
/area/shuttle/escape)
"bB" = (
/obj/effect/decal/cleanable/dirt,
/turf/open/floor/plasteel,
/area/shuttle/escape)
"bC" = (
/obj/structure/extinguisher_cabinet{
	pixel_x = -5;
	pixel_y = 30
	},
/obj/effect/decal/cleanable/blood/old,
/obj/machinery/light/small{
	dir = 1
	},
/obj/effect/decal/cleanable/dirt,
/turf/open/floor/plasteel,
/area/shuttle/escape)
"bD" = (
/obj/effect/decal/cleanable/dirt,
/obj/machinery/stasis,
/turf/open/floor/plasteel,
/area/shuttle/escape)
"bF" = (
/obj/structure/table,
/obj/item/storage/firstaid/brute,
/obj/item/storage/firstaid/regular{
	pixel_x = 2;
	pixel_y = 3
	},
/obj/item/crowbar,
/obj/effect/decal/cleanable/dirt,
/turf/open/floor/plasteel,
/area/shuttle/escape)
"bG" = (
/obj/structure/closet,
/turf/open/floor/plating,
/area/shuttle/escape)
"bH" = (
/obj/structure/closet,
/obj/item/reagent_containers/food/drinks/beer,
/obj/item/reagent_containers/food/drinks/beer,
/obj/item/reagent_containers/food/drinks/beer,
/obj/item/reagent_containers/food/drinks/beer,
/obj/item/reagent_containers/food/drinks/beer,
/obj/item/reagent_containers/food/drinks/beer,
/turf/open/floor/plating,
/area/shuttle/escape)
"bI" = (
/obj/structure/closet/crate,
/turf/open/floor/plating,
/area/shuttle/escape)
"bJ" = (
/obj/effect/decal/cleanable/blood/old,
/obj/effect/decal/cleanable/dirt,
/turf/open/floor/plasteel,
/area/shuttle/escape)
"bK" = (
/obj/structure/window/reinforced{
	dir = 1
	},
/obj/structure/shuttle/engine/heater,
/turf/open/floor/plating/airless,
/area/shuttle/escape)
"bL" = (
/obj/structure/shuttle/engine/propulsion,
/turf/open/floor/plating/airless,
/area/shuttle/escape)
"bM" = (
/obj/machinery/light/small{
	dir = 4
	},
/turf/open/floor/engine,
/area/shuttle/escape)
"bN" = (
/obj/machinery/light{
	dir = 1
	},
/turf/open/floor/mineral/plastitanium/red,
/area/shuttle/escape)
"bO" = (
/obj/structure/chair/comfy/shuttle{
	dir = 4
	},
/obj/machinery/light/small{
	brightness = 3;
	dir = 8
	},
/turf/open/floor/mineral/plastitanium,
/area/shuttle/escape)
"bP" = (
/obj/structure/kitchenspike,
/obj/machinery/light/small{
	dir = 4
	},
/turf/open/floor/mineral/plastitanium,
/area/shuttle/escape)
"bQ" = (
/obj/machinery/light,
/turf/open/floor/mineral/plastitanium/red,
/area/shuttle/escape)
"bR" = (
/obj/machinery/light/small{
	dir = 1
	},
/turf/open/floor/plating,
/area/shuttle/escape)
"iJ" = (
/obj/effect/decal/cleanable/dirt,
/obj/structure/table,
/obj/item/storage/backpack/duffelbag/med/surgery,
/obj/item/clothing/gloves/fingerless,
/turf/open/floor/plasteel,
/area/shuttle/escape)
"wq" = (
/obj/effect/decal/cleanable/dirt,
/obj/structure/table/optable,
/turf/open/floor/plasteel,
/area/shuttle/escape)

(1,1,1) = {"
aa
aa
aa
aa
ad
ab
ad
aO
ab
aW
ad
ac
ac
ac
ad
br
ad
br
ad
aa
aa
aa
"}
(2,1,1) = {"
aa
aa
aa
aa
ab
av
aF
aH
ad
ax
aJ
aJ
aJ
aJ
bO
ax
ab
bx
ab
ab
aa
aa
"}
(3,1,1) = {"
aa
aa
aa
aa
as
av
aG
aP
ad
aX
ax
bj
ax
ax
ax
bs
ad
by
bx
ab
ad
aa
"}
(4,1,1) = {"
aa
ad
ab
ab
ab
av
aH
aP
ab
ax
bc
bc
bc
bc
bc
aR
bu
bx
bx
bG
ad
ad
"}
(5,1,1) = {"
ab
ab
ai
an
ad
ac
aI
ac
ad
bN
bd
bd
bd
bd
bd
ax
ad
bR
by
bH
bK
bL
"}
(6,1,1) = {"
ac
ae
aj
ao
ad
aw
ax
ax
aR
ax
aR
ax
aR
ax
bj
ax
ab
by
bx
bI
bK
bL
"}
(7,1,1) = {"
ac
af
ak
ak
at
ax
aJ
aJ
aJ
aJ
be
ax
bc
bc
bc
ax
ab
bz
bx
bI
bK
bL
"}
(8,1,1) = {"
ac
ag
ak
ap
ab
ay
ay
ay
aS
aY
bf
ax
ax
ax
ax
bQ
bv
ad
ad
ad
bK
bL
"}
(9,1,1) = {"
ac
af
al
aq
au
az
aK
aQ
aA
aZ
ax
ax
bl
ax
ax
ax
ad
bA
bD
bA
bK
bL
"}
(10,1,1) = {"
ac
ah
ak
aq
au
aA
aL
aB
aK
ba
bg
ax
ax
ax
bq
ax
ac
bB
bB
bJ
bK
bL
"}
(11,1,1) = {"
ad
ab
am
ar
au
aB
aA
aA
aT
bb
bh
ax
bm
bo
ax
ax
bw
bB
bB
bF
bK
bL
"}
(12,1,1) = {"
aa
ad
ab
ad
as
aC
aK
bM
aQ
ba
bh
ax
bn
bp
aR
ax
ac
bB
bB
bD
ad
ad
"}
(13,1,1) = {"
aa
aa
aa
aa
ab
aD
aM
aE
aU
aD
ax
ax
aR
ax
ax
ax
ad
bC
iJ
ad
ad
aa
"}
(14,1,1) = {"
aa
aa
aa
aa
ab
aE
aN
aN
aV
aD
bi
bk
bk
bk
bP
bt
ab
wq
ab
ad
aa
aa
"}
(15,1,1) = {"
aa
aa
aa
aa
ad
aD
aE
aE
aE
aE
ad
ac
ac
ac
ad
ad
ad
ac
ad
aa
aa
aa
"}
