//MAP CONVERTED BY dmm2tgm.py THIS HEADER COMMENT PREVENTS RECONVERSION, DO NOT REMOVE
"a" = (
/turf/closed/wall/mineral/titanium,
/area/shuttle/mining)
"b" = (
/obj/effect/spawner/structure/window/shuttle,
/turf/open/floor/plating,
/area/shuttle/mining)
"c" = (
/obj/structure/table/reinforced,
/obj/item/storage/toolbox/emergency,
/obj/effect/turf_decal/stripes/line{
	dir = 9
	},
/obj/machinery/light/small{
	dir = 8
	},
/turf/open/floor/plasteel,
/area/shuttle/mining)
"d" = (
/obj/machinery/computer/shuttle/mining,
/obj/effect/decal/cleanable/dirt,
/obj/effect/turf_decal/stripes/line{
	dir = 1
	},
/turf/open/floor/plasteel,
/area/shuttle/mining)
"e" = (
/obj/structure/table/reinforced,
/obj/effect/decal/cleanable/dirt,
/obj/item/crowbar/red,
/obj/item/wrench,
/obj/item/tank/internals/emergency_oxygen,
/obj/item/clothing/mask/gas,
/obj/effect/turf_decal/stripes/line{
	dir = 5
	},
/obj/machinery/light/small{
	dir = 4
	},
/turf/open/floor/plasteel,
/area/shuttle/mining)
"f" = (
/obj/effect/turf_decal/stripes/line{
	dir = 8
	},
/turf/open/floor/plasteel,
/area/shuttle/mining)
"g" = (
/obj/structure/chair/comfy/shuttle{
	dir = 1
	},
/obj/effect/turf_decal/tile/neutral{
	dir = 1
	},
/obj/effect/turf_decal/tile/neutral,
/obj/effect/turf_decal/tile/neutral{
	dir = 4
	},
/obj/effect/turf_decal/tile/neutral{
	dir = 8
	},
/turf/open/floor/plasteel,
/area/shuttle/mining)
"h" = (
/obj/effect/decal/cleanable/dirt,
/obj/effect/decal/cleanable/blood/old,
/obj/effect/turf_decal/stripes/line{
	dir = 4
	},
/turf/open/floor/plasteel,
/area/shuttle/mining)
"i" = (
/obj/machinery/door/airlock/shuttle{
	name = "Mining Shuttle Airlock"
	},
/obj/effect/turf_decal/stripes/line{
	dir = 8
	},
/obj/effect/turf_decal/stripes/line{
	dir = 4
	},
/obj/docking_port/mobile{
	dir = 4;
	dwidth = 3;
	height = 5;
	id = "mining";
	name = "mining shuttle";
	port_direction = 8;
	width = 7
	},
/obj/effect/mapping_helpers/airlock/cyclelink_helper{
	dir = 4
	},
/turf/open/floor/plasteel/white,
/area/shuttle/mining)
"j" = (
/obj/effect/decal/cleanable/dirt,
/obj/effect/turf_decal/stripes/line{
	dir = 8
	},
/turf/open/floor/plasteel,
/area/shuttle/mining)
"k" = (
/obj/effect/turf_decal/tile/neutral{
	dir = 1
	},
/obj/effect/turf_decal/tile/neutral,
/obj/effect/turf_decal/tile/neutral{
	dir = 4
	},
/obj/effect/turf_decal/tile/neutral{
	dir = 8
	},
/turf/open/floor/plasteel,
/area/shuttle/mining)
"l" = (
/obj/effect/turf_decal/stripes/line{
	dir = 4
	},
/turf/open/floor/plasteel,
/area/shuttle/mining)
"m" = (
/obj/machinery/door/airlock/shuttle{
	name = "Mining Shuttle Airlock"
	},
/obj/effect/turf_decal/stripes/line{
	dir = 8
	},
/obj/effect/turf_decal/stripes/line{
	dir = 4
	},
/obj/effect/mapping_helpers/airlock/cyclelink_helper{
	dir = 8
	},
/turf/open/floor/plasteel/white,
/area/shuttle/mining)
"n" = (
/obj/structure/chair/comfy/shuttle{
	dir = 1
	},
/obj/effect/decal/cleanable/dirt,
/obj/effect/turf_decal/stripes/end{
	dir = 8
	},
/turf/open/floor/plasteel,
/area/shuttle/mining)
"o" = (
/obj/structure/chair/comfy/shuttle{
	dir = 1
	},
/obj/effect/decal/cleanable/dirt,
/obj/effect/turf_decal/stripes/line,
/obj/effect/turf_decal/stripes/line{
	dir = 1
	},
/turf/open/floor/plasteel,
/area/shuttle/mining)
"p" = (
/obj/structure/chair/comfy/shuttle{
	dir = 1
	},
/obj/effect/decal/cleanable/dirt,
/obj/effect/turf_decal/stripes/end{
	dir = 4
	},
/turf/open/floor/plasteel,
/area/shuttle/mining)
"q" = (
/obj/item/clothing/suit/hazardvest{
	desc = "A high-visibility lifejacket complete with whistle and slot for oxygen tanks.";
	name = "emergency lifejacket"
	},
/obj/item/clothing/suit/hazardvest{
	desc = "A high-visibility lifejacket complete with whistle and slot for oxygen tanks.";
	name = "emergency lifejacket"
	},
/obj/item/clothing/suit/hazardvest{
	desc = "A high-visibility lifejacket complete with whistle and slot for oxygen tanks.";
	name = "emergency lifejacket"
	},
/obj/item/clothing/suit/hazardvest{
	desc = "A high-visibility lifejacket complete with whistle and slot for oxygen tanks.";
	name = "emergency lifejacket"
	},
/obj/item/clothing/suit/hazardvest{
	desc = "A high-visibility lifejacket complete with whistle and slot for oxygen tanks.";
	name = "emergency lifejacket"
	},
/obj/item/tank/internals/emergency_oxygen{
	pixel_x = 3
	},
/obj/item/tank/internals/emergency_oxygen{
	pixel_x = 3
	},
/obj/item/tank/internals/emergency_oxygen{
	pixel_x = 3
	},
/obj/item/tank/internals/emergency_oxygen{
	pixel_x = 3
	},
/obj/item/tank/internals/emergency_oxygen{
	pixel_x = 3
	},
/obj/item/clothing/mask/breath{
	pixel_x = -3;
	pixel_y = -3
	},
/obj/item/clothing/mask/breath{
	pixel_x = -3;
	pixel_y = -3
	},
/obj/item/clothing/mask/breath{
	pixel_x = -3;
	pixel_y = -3
	},
/obj/item/clothing/mask/breath{
	pixel_x = -3;
	pixel_y = -3
	},
/obj/item/clothing/mask/breath{
	pixel_x = -3;
	pixel_y = -3
	},
/obj/item/clothing/head/hardhat/orange{
	name = "protective hat";
	pixel_y = 9
	},
/obj/item/clothing/head/hardhat/orange{
	name = "protective hat";
	pixel_y = 9
	},
/obj/item/clothing/head/hardhat/orange{
	name = "protective hat";
	pixel_y = 9
	},
/obj/item/clothing/head/hardhat/orange{
	name = "protective hat";
	pixel_y = 9
	},
/obj/item/clothing/head/hardhat/orange{
	name = "protective hat";
	pixel_y = 9
	},
/obj/structure/closet/crate/internals,
/obj/effect/decal/cleanable/dirt,
/obj/item/pickaxe/emergency,
/obj/item/pickaxe/emergency,
/obj/effect/turf_decal/delivery,
/obj/machinery/light/small{
	dir = 8
	},
/turf/open/floor/plasteel,
/area/shuttle/mining)
"r" = (
/obj/structure/shuttle/engine/heater,
/obj/structure/window/reinforced{
	dir = 4
	},
/obj/structure/window/reinforced{
	dir = 1
	},
/obj/structure/window/reinforced{
	dir = 8
	},
/obj/effect/turf_decal/stripes/line,
/turf/open/floor/plating/airless,
/area/shuttle/mining)
"s" = (
/obj/structure/ore_box,
/obj/effect/decal/cleanable/dirt,
/obj/effect/turf_decal/delivery,
/obj/machinery/light/small{
	dir = 4
	},
/turf/open/floor/plasteel,
/area/shuttle/mining)
"t" = (
/obj/structure/shuttle/engine/propulsion/burst,
/obj/structure/window/reinforced{
	dir = 1;
	layer = 2.9
	},
/obj/effect/turf_decal/stripes/line,
/turf/open/floor/plating/airless,
/area/shuttle/mining)

(1,1,1) = {"
a
a
b
i
b
a
a
"}
(2,1,1) = {"
a
c
f
j
n
q
a
"}
(3,1,1) = {"
b
d
g
k
o
r
t
"}
(4,1,1) = {"
a
e
h
l
p
s
a
"}
(5,1,1) = {"
a
a
b
m
b
a
a
"}
