//MAP CONVERTED BY dmm2tgm.py THIS HEADER COMMENT PREVENTS RECONVERSION, DO NOT REMOVE
"aa" = (
/obj/structure/chair/comfy/shuttle{
	dir = 1
	},
/obj/machinery/light/small{
	dir = 8
	},
/obj/machinery/airalarm/all_access{
	dir = 4;
	pixel_x = -24
	},
/obj/machinery/atmospherics/components/unary/vent_pump/on,
/obj/effect/decal/cleanable/dirt,
/turf/open/floor/pod/dark,
/area/shuttle/pirate)
"ab" = (
/obj/structure/table,
/obj/effect/decal/cleanable/dirt,
/obj/machinery/recharger,
/obj/effect/turf_decal/tile/red{
	dir = 1
	},
/obj/effect/turf_decal/tile/red,
/obj/effect/turf_decal/tile/red{
	dir = 8
	},
/turf/open/floor/plasteel/dark,
/area/shuttle/pirate)
"ac" = (
/obj/machinery/computer/shuttle/pirate,
/obj/effect/decal/cleanable/dirt,
/obj/effect/turf_decal/tile/red,
/obj/effect/turf_decal/tile/red{
	dir = 8
	},
/turf/open/floor/plasteel/dark,
/area/shuttle/pirate)
"ad" = (
/obj/structure/table,
/obj/machinery/button/door{
	id = "piratebridge";
	name = "Bridge Shutters Control";
	pixel_y = -5
	},
/obj/item/radio/intercom{
	pixel_y = 5
	},
/obj/effect/decal/cleanable/dirt,
/obj/effect/turf_decal/tile/red,
/obj/effect/turf_decal/tile/red{
	dir = 4
	},
/obj/effect/turf_decal/tile/red{
	dir = 8
	},
/turf/open/floor/plasteel/dark,
/area/shuttle/pirate)
"ae" = (
/obj/effect/decal/cleanable/dirt,
/obj/effect/turf_decal/tile/red{
	dir = 1
	},
/turf/open/floor/plasteel/dark,
/area/shuttle/pirate)
"af" = (
/turf/template_noop,
/area/template_noop)
"ag" = (
/obj/structure/chair/comfy/shuttle{
	dir = 1
	},
/turf/open/floor/plasteel/dark,
/area/shuttle/pirate)
"ah" = (
/obj/effect/decal/cleanable/dirt,
/obj/effect/turf_decal/tile/red{
	dir = 4
	},
/turf/open/floor/plasteel/dark,
/area/shuttle/pirate)
"ai" = (
/obj/machinery/atmospherics/components/unary/vent_pump/on{
	dir = 1
	},
/obj/effect/decal/cleanable/dirt,
/obj/machinery/light/small,
/turf/open/floor/pod/dark,
/area/shuttle/pirate)
"aj" = (
/turf/closed/wall/mineral/plastitanium/nodiagonal,
/area/shuttle/pirate)
"ak" = (
/obj/machinery/airalarm/all_access{
	dir = 4;
	pixel_x = -24
	},
/obj/effect/decal/cleanable/dirt,
/obj/machinery/light/small{
	dir = 8
	},
/obj/structure/closet/secure_closet/freezer{
	locked = 0;
	name = "fridge"
	},
/obj/item/storage/box/donkpockets{
	pixel_x = 2;
	pixel_y = 3
	},
/obj/item/storage/box/donkpockets,
/obj/item/storage/fancy/donut_box,
/obj/item/reagent_containers/food/snacks/cookie,
/obj/item/reagent_containers/food/snacks/cookie{
	pixel_x = -6;
	pixel_y = -6
	},
/obj/item/reagent_containers/food/snacks/chocolatebar,
/obj/effect/decal/cleanable/dirt,
/obj/effect/turf_decal/tile/bar,
/obj/effect/turf_decal/tile/bar{
	dir = 1
	},
/obj/item/reagent_containers/food/condiment/milk,
/obj/item/reagent_containers/food/condiment/milk,
/turf/open/floor/plasteel,
/area/shuttle/pirate)
"al" = (
/obj/machinery/loot_locator,
/obj/effect/decal/cleanable/dirt,
/obj/effect/turf_decal/tile/red{
	dir = 1
	},
/obj/effect/turf_decal/tile/red{
	dir = 4
	},
/obj/effect/turf_decal/tile/red{
	dir = 8
	},
/turf/open/floor/plasteel/dark,
/area/shuttle/pirate)
"am" = (
/obj/machinery/atmospherics/components/unary/vent_pump/on,
/obj/effect/turf_decal/tile/neutral{
	dir = 1
	},
/obj/effect/turf_decal/tile/neutral,
/obj/effect/turf_decal/tile/neutral{
	dir = 4
	},
/obj/effect/turf_decal/tile/neutral{
	dir = 8
	},
/turf/open/floor/plasteel/dark,
/area/shuttle/pirate)
"an" = (
/obj/structure/chair/comfy/shuttle{
	dir = 4
	},
/obj/machinery/button/door{
	id = "piratebridgebolt";
	name = "Bridge Bolt Control";
	normaldoorcontrol = 1;
	pixel_y = -24;
	specialfunctions = 4
	},
/obj/effect/turf_decal/tile/red,
/turf/open/floor/plasteel/dark,
/area/shuttle/pirate)
"ao" = (
/obj/structure/chair/comfy/shuttle{
	dir = 1
	},
/obj/machinery/light/small{
	dir = 4
	},
/obj/machinery/airalarm/all_access{
	dir = 8;
	pixel_x = 24
	},
/obj/machinery/atmospherics/components/unary/vent_pump/on,
/obj/effect/decal/cleanable/dirt,
/turf/open/floor/pod/dark,
/area/shuttle/pirate)
"ap" = (
/obj/machinery/door/airlock/hatch{
	name = "Port Gun Battery"
	},
/obj/structure/barricade/wooden/crude,
/obj/machinery/atmospherics/pipe/simple/supply/hidden,
/obj/effect/decal/cleanable/dirt,
/turf/open/floor/pod/dark,
/area/shuttle/pirate)
"aq" = (
/obj/structure/chair/stool,
/obj/machinery/atmospherics/components/unary/vent_pump/on{
	dir = 4
	},
/obj/effect/decal/cleanable/dirt,
/obj/effect/turf_decal/tile/bar,
/obj/effect/turf_decal/tile/bar{
	dir = 1
	},
/turf/open/floor/plasteel,
/area/shuttle/pirate)
"ar" = (
/obj/effect/decal/cleanable/dirt,
/obj/structure/table,
/obj/item/storage/fancy/cigarettes{
	pixel_x = 2;
	pixel_y = 6
	},
/obj/item/storage/fancy/cigarettes/cigpack_carp{
	pixel_x = 10;
	pixel_y = 6
	},
/obj/item/storage/fancy/cigarettes/cigpack_robust{
	pixel_x = 2
	},
/obj/item/storage/fancy/cigarettes/cigpack_midori{
	pixel_x = 10
	},
/obj/item/storage/fancy/cigarettes/cigpack_shadyjims{
	pixel_x = 2;
	pixel_y = -6
	},
/obj/item/storage/fancy/cigarettes/cigpack_uplift{
	pixel_x = 10;
	pixel_y = -6
	},
/obj/item/lighter{
	pixel_x = -10;
	pixel_y = -2
	},
/obj/effect/decal/cleanable/dirt,
/obj/effect/turf_decal/tile/bar,
/obj/effect/turf_decal/tile/bar{
	dir = 1
	},
/turf/open/floor/plasteel,
/area/shuttle/pirate)
"au" = (
/obj/machinery/door/airlock/hatch{
	id_tag = "piratebridgebolt";
	name = "Bridge"
	},
/obj/machinery/atmospherics/pipe/simple/supply/hidden,
/obj/effect/turf_decal/tile/neutral{
	dir = 1
	},
/obj/effect/turf_decal/tile/neutral,
/obj/effect/turf_decal/tile/neutral{
	dir = 4
	},
/obj/effect/turf_decal/tile/neutral{
	dir = 8
	},
/turf/open/floor/plasteel/dark,
/area/shuttle/pirate)
"av" = (
/obj/machinery/door/airlock/hatch{
	name = "Starboard Gun Battery"
	},
/obj/structure/barricade/wooden/crude,
/obj/machinery/atmospherics/pipe/simple/supply/hidden,
/obj/effect/decal/cleanable/dirt,
/turf/open/floor/pod/dark,
/area/shuttle/pirate)
"aw" = (
/obj/machinery/atmospherics/pipe/simple/supply/hidden{
	dir = 5
	},
/obj/effect/decal/cleanable/dirt,
/obj/effect/turf_decal/tile/bar,
/obj/effect/turf_decal/tile/bar{
	dir = 1
	},
/turf/open/floor/plasteel,
/area/shuttle/pirate)
"ax" = (
/obj/machinery/firealarm{
	pixel_y = 24
	},
/obj/machinery/atmospherics/pipe/simple/supply/hidden{
	dir = 4
	},
/obj/effect/turf_decal/tile/bar,
/obj/effect/turf_decal/tile/bar{
	dir = 1
	},
/turf/open/floor/plasteel,
/area/shuttle/pirate)
"ay" = (
/obj/machinery/atmospherics/pipe/simple/supply/hidden{
	dir = 10
	},
/obj/effect/decal/cleanable/dirt,
/obj/effect/decal/cleanable/vomit/old,
/obj/effect/turf_decal/tile/bar,
/obj/effect/turf_decal/tile/bar{
	dir = 1
	},
/turf/open/floor/plasteel,
/area/shuttle/pirate)
"az" = (
/obj/effect/decal/cleanable/dirt,
/obj/structure/table,
/obj/machinery/chem_dispenser/drinks{
	dir = 8
	},
/obj/effect/turf_decal/tile/bar,
/obj/effect/turf_decal/tile/bar{
	dir = 1
	},
/turf/open/floor/plasteel,
/area/shuttle/pirate)
"aB" = (
/obj/machinery/light/small{
	dir = 4
	},
/obj/machinery/computer/monitor/secret{
	dir = 8
	},
/obj/effect/decal/cleanable/dirt,
/obj/machinery/airalarm/all_access{
	dir = 1;
	pixel_y = -24
	},
/obj/effect/turf_decal/tile/red{
	dir = 1
	},
/obj/effect/turf_decal/tile/red,
/obj/effect/turf_decal/tile/red{
	dir = 8
	},
/turf/open/floor/plasteel/dark,
/area/shuttle/pirate)
"aC" = (
/obj/machinery/shuttle_scrambler,
/obj/effect/decal/cleanable/dirt,
/obj/effect/turf_decal/tile/red{
	dir = 1
	},
/obj/effect/turf_decal/tile/red,
/obj/effect/turf_decal/tile/red{
	dir = 4
	},
/turf/open/floor/plasteel/dark,
/area/shuttle/pirate)
"aD" = (
/obj/effect/decal/cleanable/dirt,
/turf/open/floor/plating,
/area/shuttle/pirate)
"aF" = (
/obj/machinery/door/airlock/external/glass{
	id_tag = "pirateportexternal"
	},
/obj/effect/mapping_helpers/airlock/locked,
/obj/effect/mapping_helpers/airlock/cyclelink_helper,
/obj/effect/decal/cleanable/dirt,
/turf/open/floor/plating,
/area/shuttle/pirate)
"aG" = (
/obj/effect/turf_decal/stripes/line{
	dir = 1
	},
/obj/machinery/power/port_gen/pacman{
	anchored = 1
	},
/obj/effect/decal/cleanable/dirt,
/obj/structure/cable,
/turf/open/floor/plating,
/area/shuttle/pirate)
"aH" = (
/obj/structure/shuttle/engine/propulsion/left,
/turf/open/floor/plating/airless,
/area/shuttle/pirate)
"aI" = (
/obj/machinery/light/small{
	dir = 8
	},
/obj/structure/sign/warning/vacuum/external{
	pixel_x = -32
	},
/obj/effect/decal/cleanable/dirt,
/turf/open/floor/plating,
/area/shuttle/pirate)
"aJ" = (
/obj/machinery/door/airlock/external/glass{
	id_tag = "pirateportexternal"
	},
/obj/effect/mapping_helpers/airlock/locked,
/obj/effect/mapping_helpers/airlock/cyclelink_helper{
	dir = 1
	},
/turf/open/floor/plating,
/area/shuttle/pirate)
"aK" = (
/obj/structure/shuttle/engine/propulsion,
/turf/open/floor/plating/airless,
/area/shuttle/pirate)
"aL" = (
/obj/machinery/atmospherics/pipe/manifold/supply/hidden{
	dir = 4
	},
/obj/effect/decal/cleanable/dirt,
/turf/open/floor/plating,
/area/shuttle/pirate)
"aM" = (
/obj/structure/closet/secure_closet/personal,
/obj/effect/decal/cleanable/dirt,
/obj/effect/turf_decal/stripes/line,
/turf/open/floor/wood,
/area/shuttle/pirate)
"aN" = (
/obj/machinery/light/small,
/obj/machinery/button/door{
	id = "pirateportexternal";
	name = "External Bolt Control";
	normaldoorcontrol = 1;
	pixel_x = -4;
	pixel_y = -24;
	specialfunctions = 4
	},
/obj/effect/turf_decal/stripes/corner{
	dir = 8
	},
/obj/effect/decal/cleanable/dirt,
/turf/open/floor/plating,
/area/shuttle/pirate)
"aO" = (
/obj/machinery/light/small,
/obj/machinery/button/door{
	id = "piratestarboardexternal";
	name = "External Bolt Control";
	normaldoorcontrol = 1;
	pixel_x = 4;
	pixel_y = -24;
	specialfunctions = 4
	},
/obj/effect/turf_decal/stripes/corner,
/obj/effect/decal/cleanable/dirt,
/turf/open/floor/plating,
/area/shuttle/pirate)
"aQ" = (
/obj/machinery/porta_turret/syndicate/energy{
	dir = 1;
	faction = list("pirate")
	},
/turf/closed/wall/mineral/plastitanium/nodiagonal,
/area/shuttle/pirate)
"aR" = (
/obj/machinery/porta_turret/syndicate/energy{
	faction = list("pirate")
	},
/turf/closed/wall/mineral/plastitanium,
/area/shuttle/pirate)
"aS" = (
/obj/effect/turf_decal/stripes/line,
/obj/effect/decal/cleanable/dirt,
/turf/open/floor/plating,
/area/shuttle/pirate)
"aU" = (
/obj/structure/sign/departments/engineering,
/turf/closed/wall/mineral/plastitanium/nodiagonal,
/area/shuttle/pirate)
"aV" = (
/obj/effect/mob_spawn/human/pirate{
	dir = 1
	},
/obj/effect/turf_decal/stripes/line,
/obj/effect/turf_decal/tile/neutral{
	dir = 1
	},
/obj/effect/turf_decal/tile/neutral,
/obj/effect/turf_decal/tile/neutral{
	dir = 4
	},
/obj/effect/turf_decal/tile/neutral{
	dir = 8
	},
/turf/open/floor/plasteel/dark,
/area/shuttle/pirate)
"aW" = (
/obj/machinery/light/small{
	dir = 8
	},
/obj/machinery/computer/camera_advanced/shuttle_docker/syndicate/pirate{
	dir = 4;
	x_offset = -3;
	y_offset = 7
	},
/obj/effect/decal/cleanable/dirt,
/obj/machinery/firealarm{
	dir = 1;
	pixel_y = -24
	},
/obj/effect/turf_decal/tile/red,
/obj/effect/turf_decal/tile/red{
	dir = 4
	},
/obj/effect/turf_decal/tile/red{
	dir = 8
	},
/turf/open/floor/plasteel/dark,
/area/shuttle/pirate)
"be" = (
/obj/machinery/space_heater,
/obj/effect/turf_decal/bot,
/obj/machinery/atmospherics/pipe/simple/supply/hidden{
	dir = 4
	},
/obj/effect/decal/cleanable/dirt,
/obj/effect/decal/cleanable/oil,
/turf/open/floor/plating,
/area/shuttle/pirate)
"bf" = (
/obj/structure/chair/comfy/shuttle{
	dir = 8
	},
/obj/effect/decal/cleanable/dirt,
/obj/machinery/turretid{
	icon_state = "control_kill";
	lethal = 1;
	locked = 0;
	pixel_y = -24;
	req_access = null
	},
/obj/effect/turf_decal/tile/red{
	dir = 8
	},
/turf/open/floor/plasteel/dark,
/area/shuttle/pirate)
"bg" = (
/obj/effect/turf_decal/stripes/line,
/obj/effect/decal/cleanable/dirt,
/obj/structure/table,
/obj/item/gun/energy/laser{
	pixel_x = -3;
	pixel_y = 6
	},
/obj/item/gun/energy/laser{
	pixel_y = 3
	},
/obj/machinery/recharger,
/turf/open/floor/pod/light,
/area/shuttle/pirate)
"bk" = (
/obj/effect/turf_decal/stripes/line{
	dir = 1
	},
/obj/machinery/power/smes/engineering{
	charge = 1e+006
	},
/obj/effect/decal/cleanable/dirt,
/obj/structure/cable,
/turf/open/floor/plating,
/area/shuttle/pirate)
"bl" = (
/obj/effect/turf_decal/stripes/line{
	dir = 6
	},
/obj/machinery/light/small{
	dir = 1
	},
/obj/machinery/airalarm/all_access{
	pixel_y = 24
	},
/obj/effect/decal/cleanable/dirt,
/obj/structure/table,
/obj/item/gun/energy/laser{
	pixel_x = -3;
	pixel_y = 6
	},
/obj/item/gun/energy/laser{
	pixel_y = 3
	},
/turf/open/floor/pod/light,
/area/shuttle/pirate)
"bm" = (
/obj/machinery/atmospherics/pipe/simple/supply/hidden,
/turf/open/floor/pod/dark,
/area/shuttle/pirate)
"bo" = (
/obj/machinery/light/small{
	dir = 4
	},
/obj/structure/sign/warning/vacuum/external{
	pixel_x = 32
	},
/turf/open/floor/plating,
/area/shuttle/pirate)
"br" = (
/obj/structure/table/wood,
/obj/item/storage/box/matches,
/obj/item/reagent_containers/food/drinks/bottle/rum{
	name = "Captain Pete's Private Reserve Cuban Spaced Rum";
	pixel_x = -6;
	pixel_y = 8
	},
/obj/item/reagent_containers/food/drinks/drinkingglass/shotglass{
	pixel_x = 6;
	pixel_y = 12
	},
/obj/item/clothing/mask/cigarette/cigar,
/obj/effect/decal/cleanable/dirt,
/obj/effect/turf_decal/stripes/line,
/turf/open/floor/wood,
/area/shuttle/pirate)
"bt" = (
/obj/effect/turf_decal/stripes/line{
	dir = 10
	},
/obj/machinery/light/small{
	dir = 1
	},
/obj/machinery/firealarm{
	pixel_y = 24
	},
/obj/effect/decal/cleanable/dirt,
/obj/structure/table,
/obj/item/melee/transforming/energy/sword/pirate{
	pixel_x = -1;
	pixel_y = 6
	},
/obj/item/melee/transforming/energy/sword/pirate{
	pixel_x = 6;
	pixel_y = 6
	},
/obj/item/melee/transforming/energy/sword/pirate{
	pixel_x = 13;
	pixel_y = 6
	},
/turf/open/floor/pod/light,
/area/shuttle/pirate)
"bu" = (
/obj/machinery/firealarm{
	pixel_y = 24
	},
/obj/machinery/atmospherics/pipe/simple/supply/hidden{
	dir = 4
	},
/obj/effect/decal/cleanable/dirt,
/turf/open/floor/plasteel,
/area/shuttle/pirate)
"bv" = (
/obj/machinery/atmospherics/pipe/simple/supply/hidden{
	dir = 9
	},
/obj/effect/decal/cleanable/dirt,
/turf/open/floor/plasteel,
/area/shuttle/pirate)
"bx" = (
/obj/machinery/atmospherics/pipe/simple/supply/hidden{
	dir = 4
	},
/obj/effect/decal/cleanable/dirt,
/obj/effect/turf_decal/tile/bar,
/obj/effect/turf_decal/tile/bar{
	dir = 1
	},
/turf/open/floor/plasteel,
/area/shuttle/pirate)
"by" = (
/obj/machinery/atmospherics/pipe/manifold4w/supply/hidden,
/obj/effect/decal/cleanable/dirt,
/obj/machinery/piratepad,
/turf/open/floor/pod/dark,
/area/shuttle/pirate)
"bA" = (
/obj/machinery/atmospherics/pipe/simple/supply/hidden{
	dir = 4
	},
/turf/open/floor/pod/dark,
/area/shuttle/pirate)
"bB" = (
/obj/machinery/atmospherics/pipe/manifold/supply/hidden,
/obj/effect/decal/cleanable/dirt,
/turf/open/floor/plasteel,
/area/shuttle/pirate)
"bC" = (
/obj/machinery/airalarm/all_access{
	dir = 8;
	pixel_x = 24
	},
/obj/machinery/light/small{
	dir = 4
	},
/obj/machinery/atmospherics/pipe/manifold/supply/hidden{
	dir = 4
	},
/obj/effect/decal/cleanable/dirt,
/obj/effect/turf_decal/tile/neutral,
/turf/open/floor/plasteel,
/area/shuttle/pirate)
"bF" = (
/obj/effect/decal/cleanable/dirt,
/obj/structure/table,
/obj/machinery/microwave{
	pixel_y = 5
	},
/obj/item/book/manual/wiki/barman_recipes{
	pixel_x = -8
	},
/obj/effect/decal/cleanable/dirt,
/obj/effect/turf_decal/tile/bar,
/obj/effect/turf_decal/tile/bar{
	dir = 1
	},
/turf/open/floor/plasteel,
/area/shuttle/pirate)
"bH" = (
/obj/machinery/vending/boozeomat/all_access{
	onstation = 0
	},
/obj/effect/turf_decal/tile/bar,
/obj/effect/turf_decal/tile/bar{
	dir = 1
	},
/turf/open/floor/plasteel,
/area/shuttle/pirate)
"bI" = (
/obj/machinery/light/small,
/obj/machinery/computer/piratepad_control{
	dir = 1
	},
/turf/open/floor/pod/dark,
/area/shuttle/pirate)
"bJ" = (
/obj/machinery/atmospherics/pipe/manifold/supply/hidden{
	dir = 8
	},
/obj/effect/decal/cleanable/dirt,
/obj/effect/turf_decal/tile/neutral,
/obj/effect/turf_decal/tile/neutral{
	dir = 4
	},
/obj/effect/turf_decal/tile/neutral{
	dir = 8
	},
/turf/open/floor/plasteel,
/area/shuttle/pirate)
"bK" = (
/obj/effect/decal/cleanable/dirt,
/obj/structure/sink{
	pixel_y = 24
	},
/obj/structure/toilet{
	dir = 8
	},
/obj/machinery/light/small,
/obj/machinery/atmospherics/components/unary/vent_pump/on{
	dir = 8
	},
/turf/open/floor/plasteel/showroomfloor,
/area/shuttle/pirate)
"bM" = (
/obj/machinery/atmospherics/pipe/simple/supply/hidden,
/obj/machinery/door/airlock{
	name = "Crew Cabin"
	},
/obj/effect/decal/cleanable/dirt,
/obj/effect/turf_decal/tile/neutral{
	dir = 1
	},
/obj/effect/turf_decal/tile/neutral,
/obj/effect/turf_decal/tile/neutral{
	dir = 4
	},
/obj/effect/turf_decal/tile/neutral{
	dir = 8
	},
/turf/open/floor/plasteel/dark,
/area/shuttle/pirate)
"bO" = (
/obj/machinery/power/apc{
	aidisabled = 1;
	dir = 1;
	name = "Pirate Corvette APC";
	pixel_y = 23
	},
/obj/structure/reagent_dispensers/watertank,
/obj/effect/turf_decal/bot,
/obj/effect/decal/cleanable/dirt,
/obj/structure/cable,
/turf/open/floor/plating,
/area/shuttle/pirate)
"bP" = (
/obj/machinery/atmospherics/components/unary/vent_pump/on{
	dir = 1
	},
/obj/effect/decal/cleanable/dirt,
/turf/open/floor/plating,
/area/shuttle/pirate)
"bQ" = (
/obj/effect/decal/cleanable/dirt,
/obj/structure/cable,
/turf/open/floor/plating,
/area/shuttle/pirate)
"bX" = (
/obj/effect/decal/cleanable/dirt,
/obj/machinery/power/terminal{
	dir = 4
	},
/obj/structure/rack,
/obj/item/storage/toolbox/mechanical{
	pixel_y = 4
	},
/obj/item/flashlight{
	pixel_x = 3;
	pixel_y = 3
	},
/obj/item/storage/box/lights/bulbs,
/obj/item/stack/sheet/mineral/plasma{
	amount = 10
	},
/obj/item/multitool,
/obj/effect/turf_decal/stripes/line{
	dir = 1
	},
/obj/structure/cable,
/turf/open/floor/plating,
/area/shuttle/pirate)
"bZ" = (
/obj/machinery/door/airlock/external/glass{
	id_tag = "piratestarboardexternal"
	},
/obj/effect/mapping_helpers/airlock/locked,
/obj/effect/mapping_helpers/airlock/cyclelink_helper,
/obj/effect/decal/cleanable/dirt,
/turf/open/floor/plating,
/area/shuttle/pirate)
"ce" = (
/obj/machinery/door/airlock/external/glass{
	id_tag = "piratestarboardexternal"
	},
/obj/effect/mapping_helpers/airlock/locked,
/obj/effect/mapping_helpers/airlock/cyclelink_helper{
	dir = 1
	},
/obj/docking_port/mobile/pirate{
	dwidth = 11;
	height = 16;
	launch_status = 0;
	movement_force = list("KNOCKDOWN" = 0, "THROW" = 0);
	name = "Pirate Ship";
	port_direction = 2;
	width = 17
	},
/obj/docking_port/stationary{
	dwidth = 11;
	height = 16;
	id = "pirateship_home";
	name = "Deep Space";
	width = 17
	},
/turf/open/floor/plating,
/area/shuttle/pirate)
"df" = (
/obj/machinery/porta_turret/syndicate/energy{
	dir = 4;
	faction = list("pirate")
	},
/turf/closed/wall/mineral/plastitanium,
/area/shuttle/pirate)
"dy" = (
/obj/structure/chair/wood,
/obj/machinery/atmospherics/components/unary/vent_pump/on{
	dir = 1
	},
/obj/machinery/light/small{
	dir = 4
	},
/obj/effect/decal/cleanable/dirt,
/turf/open/floor/wood,
/area/shuttle/pirate)
"dU" = (
/obj/machinery/light/small{
	dir = 8
	},
/obj/machinery/atmospherics/components/unary/vent_pump/on{
	dir = 1
	},
/obj/effect/turf_decal/tile/neutral{
	dir = 1
	},
/obj/effect/turf_decal/tile/neutral,
/obj/effect/turf_decal/tile/neutral{
	dir = 4
	},
/obj/effect/turf_decal/tile/neutral{
	dir = 8
	},
/turf/open/floor/plasteel/dark,
/area/shuttle/pirate)
"ek" = (
/obj/effect/turf_decal/stripes/line,
/obj/effect/decal/cleanable/dirt,
/obj/structure/table,
/obj/structure/sign/poster/contraband/revolver{
	pixel_x = 32
	},
/obj/item/storage/backpack/duffelbag/syndie/x4{
	pixel_y = 8
	},
/obj/item/grenade/smokebomb{
	pixel_x = -5
	},
/obj/item/grenade/smokebomb{
	pixel_x = 5
	},
/turf/open/floor/pod/light,
/area/shuttle/pirate)
"ep" = (
/obj/structure/window/reinforced{
	dir = 1;
	pixel_y = 1
	},
/obj/structure/shuttle/engine/heater,
/turf/open/floor/plating/airless,
/area/shuttle/pirate)
"er" = (
/obj/structure/shuttle/engine/propulsion/right,
/turf/open/floor/plating/airless,
/area/shuttle/pirate)
"et" = (
/obj/structure/grille,
/turf/open/floor/plating/airless,
/area/shuttle/pirate)
"eu" = (
/obj/structure/girder,
/obj/item/stack/rods{
	amount = 3
	},
/turf/open/floor/plating/airless,
/area/shuttle/pirate)
"ew" = (
/obj/structure/girder,
/obj/item/stack/rods{
	amount = 5
	},
/turf/open/floor/plating/airless,
/area/shuttle/pirate)
"ex" = (
/obj/structure/window/reinforced,
/obj/structure/frame/machine,
/obj/item/wrench,
/turf/open/floor/plating/airless,
/area/shuttle/pirate)
"ey" = (
/obj/machinery/door/poddoor/shutters/preopen{
	id = "piratebridge"
	},
/obj/structure/grille,
/obj/structure/window/plasma/reinforced/plastitanium,
/turf/open/floor/plating,
/area/shuttle/pirate)
"ez" = (
/obj/structure/window/reinforced,
/obj/structure/frame/machine,
/obj/item/stack/cable_coil/cut,
/turf/open/floor/plating/airless,
/area/shuttle/pirate)
"eA" = (
/obj/structure/window/reinforced{
	dir = 1;
	pixel_y = 1
	},
/obj/structure/frame/computer{
	anchored = 1
	},
/obj/effect/decal/cleanable/dirt,
/turf/open/floor/pod/dark,
/area/shuttle/pirate)
"eE" = (
/obj/machinery/atmospherics/pipe/simple/supply/hidden{
	dir = 6
	},
/obj/effect/decal/cleanable/dirt,
/turf/open/floor/plasteel,
/area/shuttle/pirate)
"fW" = (
/turf/closed/wall/mineral/plastitanium,
/area/shuttle/pirate)
"fY" = (
/obj/machinery/atmospherics/pipe/manifold/supply/hidden{
	dir = 1
	},
/turf/open/floor/pod/dark,
/area/shuttle/pirate)
"gY" = (
/obj/machinery/atmospherics/pipe/simple/supply/hidden{
	dir = 4
	},
/obj/effect/decal/cleanable/dirt,
/turf/open/floor/pod/dark,
/area/shuttle/pirate)
"km" = (
/obj/machinery/atmospherics/components/unary/tank/air,
/obj/effect/turf_decal/bot,
/obj/machinery/firealarm{
	pixel_y = 24
	},
/obj/effect/decal/cleanable/dirt,
/turf/open/floor/plating,
/area/shuttle/pirate)
"mD" = (
/obj/machinery/atmospherics/components/unary/vent_pump/on,
/obj/structure/closet/secure_closet/personal,
/obj/effect/decal/cleanable/dirt,
/turf/open/floor/plasteel,
/area/shuttle/pirate)
"mU" = (
/obj/machinery/atmospherics/pipe/simple/supply/hidden,
/obj/machinery/door/airlock/engineering{
	name = "Engineering"
	},
/obj/effect/decal/cleanable/dirt,
/turf/open/floor/pod/dark,
/area/shuttle/pirate)
"np" = (
/obj/structure/reagent_dispensers/fueltank,
/obj/effect/turf_decal/bot,
/obj/machinery/airalarm/all_access{
	pixel_y = 24
	},
/obj/effect/decal/cleanable/dirt,
/turf/open/floor/plating,
/area/shuttle/pirate)
"vB" = (
/obj/effect/turf_decal/stripes/line{
	dir = 9
	},
/obj/effect/decal/cleanable/dirt,
/obj/structure/rack{
	dir = 8;
	layer = 2.9
	},
/obj/item/storage/box/lethalshot,
/obj/item/gun/ballistic/shotgun/automatic/combat{
	pixel_x = -2;
	pixel_y = 2
	},
/turf/open/floor/pod/light,
/area/shuttle/pirate)
"wf" = (
/obj/machinery/door/airlock{
	name = "Unisex Restrooms"
	},
/obj/effect/decal/cleanable/dirt,
/obj/machinery/atmospherics/pipe/simple/supply/hidden{
	dir = 4
	},
/turf/open/floor/plasteel/showroomfloor,
/area/shuttle/pirate)
"wR" = (
/obj/machinery/porta_turret/syndicate/energy{
	dir = 8;
	faction = list("pirate")
	},
/turf/closed/wall/mineral/plastitanium,
/area/shuttle/pirate)
"yi" = (
/obj/machinery/atmospherics/pipe/simple/supply/hidden{
	dir = 4
	},
/obj/machinery/door/airlock/hatch{
	name = "Armory Access"
	},
/obj/effect/decal/cleanable/dirt,
/turf/open/floor/pod/dark,
/area/shuttle/pirate)
"zw" = (
/obj/machinery/atmospherics/pipe/simple/supply/hidden,
/obj/machinery/door/airlock{
	name = "Captain's Quarters"
	},
/obj/effect/decal/cleanable/dirt,
/turf/open/floor/wood,
/area/shuttle/pirate)
"Gk" = (
/obj/effect/turf_decal/delivery,
/obj/machinery/suit_storage_unit/pirate,
/obj/effect/decal/cleanable/dirt,
/turf/open/floor/plating,
/area/shuttle/pirate)
"JT" = (
/obj/effect/turf_decal/stripes/line{
	dir = 5
	},
/obj/effect/decal/cleanable/dirt,
/obj/structure/closet/crate,
/obj/item/storage/bag/money/vault,
/obj/item/stack/sheet/mineral/gold{
	amount = 3;
	pixel_x = -2;
	pixel_y = 2
	},
/obj/item/stack/sheet/mineral/silver{
	amount = 8;
	pixel_x = 2;
	pixel_y = -1
	},
/turf/open/floor/pod/light,
/area/shuttle/pirate)
"Oe" = (
/obj/machinery/atmospherics/pipe/manifold4w/supply/hidden,
/obj/effect/turf_decal/tile/bar,
/obj/effect/turf_decal/tile/bar{
	dir = 1
	},
/turf/open/floor/plasteel,
/area/shuttle/pirate)
"OD" = (
/obj/machinery/airalarm/all_access{
	pixel_y = 24
	},
/obj/structure/sign/poster/contraband/random{
	pixel_x = 32
	},
/obj/effect/turf_decal/tile/neutral{
	dir = 1
	},
/obj/effect/turf_decal/tile/neutral,
/obj/effect/turf_decal/tile/neutral{
	dir = 4
	},
/obj/effect/turf_decal/tile/neutral{
	dir = 8
	},
/turf/open/floor/plasteel/dark,
/area/shuttle/pirate)
"OL" = (
/obj/machinery/atmospherics/pipe/simple/supply/hidden,
/obj/effect/decal/cleanable/dirt,
/obj/effect/turf_decal/tile/bar,
/obj/effect/turf_decal/tile/bar{
	dir = 1
	},
/turf/open/floor/plasteel,
/area/shuttle/pirate)
"RY" = (
/obj/effect/mob_spawn/human/pirate/captain{
	dir = 4
	},
/obj/machinery/airalarm/all_access{
	pixel_y = 24
	},
/obj/effect/decal/cleanable/dirt,
/obj/structure/sign/poster/contraband/random{
	pixel_x = -32
	},
/turf/open/floor/wood,
/area/shuttle/pirate)
"Ur" = (
/obj/structure/closet/secure_closet/personal,
/obj/effect/decal/cleanable/dirt,
/obj/effect/turf_decal/tile/neutral,
/obj/effect/turf_decal/tile/neutral{
	dir = 8
	},
/turf/open/floor/plasteel,
/area/shuttle/pirate)

(1,1,1) = {"
af
af
af
fW
aj
aj
aj
aj
aj
aj
aj
wR
af
af
af
af
"}
(2,1,1) = {"
af
et
eu
ex
eA
aa
ap
aw
ak
bF
aj
aj
aj
fW
af
af
"}
(3,1,1) = {"
aQ
aj
aj
aj
aj
aj
aj
ax
aq
ar
aj
RY
aM
ep
aH
af
"}
(4,1,1) = {"
af
af
af
af
af
af
ey
ay
Oe
OL
zw
dy
br
ep
er
af
"}
(5,1,1) = {"
af
af
af
af
af
af
aj
az
bx
bH
aj
aj
aj
aj
aj
aR
"}
(6,1,1) = {"
af
af
af
ey
ey
aj
aj
aj
yi
aj
aj
Gk
aS
aF
aI
aJ
"}
(7,1,1) = {"
af
af
ey
ey
aC
aW
aj
bg
gY
JT
aj
km
aN
aj
aj
aj
"}
(8,1,1) = {"
af
af
ey
ab
ae
bf
aj
bl
fY
ai
aU
be
aD
aG
ep
aH
"}
(9,1,1) = {"
af
af
ey
ac
ag
am
au
bm
by
bm
mU
aL
bP
bX
ep
aK
"}
(10,1,1) = {"
af
af
ey
ad
ah
an
aj
bt
gY
bI
aj
bO
bQ
bk
ep
er
"}
(11,1,1) = {"
af
af
ey
ey
al
aB
aj
ek
bA
vB
aj
np
aO
aj
aj
aj
"}
(12,1,1) = {"
af
af
af
ey
ey
aj
aj
aj
yi
aj
aj
Gk
aS
bZ
bo
ce
"}
(13,1,1) = {"
af
af
af
af
af
af
aj
mD
bB
Ur
aj
aj
aj
aj
aj
aR
"}
(14,1,1) = {"
af
af
af
af
af
af
ey
eE
bC
bJ
bM
dU
aV
ep
aH
af
"}
(15,1,1) = {"
aQ
aj
aj
aj
aj
aj
aj
bu
aj
wf
aj
OD
aV
ep
er
af
"}
(16,1,1) = {"
af
et
ew
ez
eA
ao
av
bv
aj
bK
aj
aj
aj
fW
af
af
"}
(17,1,1) = {"
af
af
af
fW
aj
aj
aj
aj
aj
aj
aj
df
af
af
af
af
"}
