//MAP CONVERTED BY dmm2tgm.py THIS HEADER COMMENT PREVENTS RECONVERSION, DO NOT REMOVE
"af" = (
/turf/closed/wall/mineral/plastitanium/nodiagonal,
/area/shuttle/caravan/pirate)
"aE" = (
/obj/structure/closet{
	name = "pirate outfits"
	},
/obj/item/clothing/head/collectable/pirate,
/obj/item/clothing/suit/pirate,
/obj/item/clothing/under/costume/pirate,
/obj/item/clothing/shoes/jackboots,
/obj/item/clothing/head/bandana,
/turf/open/floor/plasteel/dark/side{
	dir = 5
	},
/area/shuttle/caravan/pirate)
"bd" = (
/obj/structure/table/reinforced,
/obj/machinery/button/door{
	id = "caravanpirate_bridge";
	name = "Bridge Blast Door Control";
	pixel_x = -16
	},
/obj/effect/turf_decal/tile/red,
/obj/effect/turf_decal/tile/red{
	dir = 8
	},
/turf/open/floor/plasteel/dark,
/area/shuttle/caravan/pirate)
"bH" = (
/obj/machinery/atmospherics/pipe/simple/supply/hidden{
	dir = 5
	},
/obj/effect/decal/cleanable/dirt,
/turf/open/floor/plasteel,
/area/shuttle/caravan/pirate)
"de" = (
/obj/machinery/atmospherics/pipe/manifold/supply/hidden{
	dir = 8
	},
/obj/effect/turf_decal/tile/neutral{
	dir = 1
	},
/obj/effect/turf_decal/tile/neutral,
/obj/effect/turf_decal/tile/neutral{
	dir = 4
	},
/obj/effect/turf_decal/tile/neutral{
	dir = 8
	},
/turf/open/floor/plasteel/dark,
/area/shuttle/caravan/pirate)
"dE" = (
/obj/effect/turf_decal/tile/neutral{
	dir = 1
	},
/obj/effect/turf_decal/tile/neutral,
/obj/effect/turf_decal/tile/neutral{
	dir = 4
	},
/obj/effect/turf_decal/tile/neutral{
	dir = 8
	},
/turf/open/floor/plasteel/dark,
/area/shuttle/caravan/pirate)
"eL" = (
/obj/machinery/porta_turret/syndicate/pod{
	dir = 10;
	faction = list("pirate")
	},
/turf/closed/wall/mineral/plastitanium,
/area/shuttle/caravan/pirate)
"fh" = (
/obj/machinery/atmospherics/pipe/manifold/supply/hidden{
	dir = 4
	},
/turf/open/floor/plating,
/area/shuttle/caravan/pirate)
"fL" = (
/obj/machinery/computer/shuttle/caravan/pirate{
	dir = 8
	},
/obj/effect/turf_decal/tile/red{
	dir = 1
	},
/obj/effect/turf_decal/tile/red{
	dir = 8
	},
/turf/open/floor/plasteel/dark,
/area/shuttle/caravan/pirate)
"fS" = (
/obj/structure/bed,
/obj/item/bedsheet/brown,
/obj/machinery/airalarm/all_access{
	dir = 4;
	pixel_x = -24
	},
/obj/effect/turf_decal/tile/red{
	dir = 8
	},
/turf/open/floor/plasteel/dark,
/area/shuttle/caravan/pirate)
"fU" = (
/obj/machinery/atmospherics/pipe/manifold/supply/hidden,
/obj/effect/turf_decal/tile/red,
/obj/effect/turf_decal/tile/red{
	dir = 8
	},
/turf/open/floor/plasteel,
/area/shuttle/caravan/pirate)
"hh" = (
/mob/living/simple_animal/hostile/pirate{
	environment_smash = 0
	},
/turf/open/floor/plasteel,
/area/shuttle/caravan/pirate)
"hI" = (
/obj/machinery/atmospherics/pipe/simple/supply/hidden,
/obj/structure/cable,
/turf/open/floor/plating,
/area/shuttle/caravan/pirate)
"hT" = (
/obj/machinery/light/small{
	dir = 1
	},
/obj/structure/bed,
/obj/item/bedsheet/brown,
/turf/open/floor/plasteel/dark,
/area/shuttle/caravan/pirate)
"hZ" = (
/obj/machinery/atmospherics/pipe/simple/supply/hidden,
/obj/effect/turf_decal/tile/neutral{
	dir = 1
	},
/obj/effect/turf_decal/tile/neutral,
/obj/effect/turf_decal/tile/neutral{
	dir = 4
	},
/obj/effect/turf_decal/tile/neutral{
	dir = 8
	},
/turf/open/floor/plasteel/dark,
/area/shuttle/caravan/pirate)
"iF" = (
/obj/machinery/atmospherics/pipe/simple/supply/hidden{
	dir = 9
	},
/obj/effect/turf_decal/tile/neutral{
	dir = 1
	},
/obj/effect/turf_decal/tile/neutral,
/obj/effect/turf_decal/tile/neutral{
	dir = 4
	},
/obj/effect/turf_decal/tile/neutral{
	dir = 8
	},
/turf/open/floor/plasteel/dark,
/area/shuttle/caravan/pirate)
"iX" = (
/obj/structure/table,
/obj/machinery/door/window/southleft{
	base_state = "right";
	icon_state = "right";
	name = "Weapon Storage"
	},
/obj/item/gun/energy/laser,
/obj/effect/turf_decal/tile/neutral{
	dir = 1
	},
/obj/effect/turf_decal/tile/neutral,
/obj/effect/turf_decal/tile/neutral{
	dir = 4
	},
/obj/effect/turf_decal/tile/neutral{
	dir = 8
	},
/turf/open/floor/plasteel/dark,
/area/shuttle/caravan/pirate)
"jh" = (
/obj/machinery/power/port_gen/pacman{
	anchored = 1
	},
/obj/item/wrench,
/obj/effect/turf_decal/stripes/line{
	dir = 6
	},
/obj/structure/cable,
/turf/open/floor/plating,
/area/shuttle/caravan/pirate)
"jo" = (
/obj/structure/table,
/obj/machinery/airalarm/all_access{
	pixel_y = 24
	},
/obj/item/ammo_box/a40mm,
/obj/effect/turf_decal/tile/neutral{
	dir = 1
	},
/obj/effect/turf_decal/tile/neutral,
/obj/effect/turf_decal/tile/neutral{
	dir = 4
	},
/obj/effect/turf_decal/tile/neutral{
	dir = 8
	},
/turf/open/floor/plasteel/dark,
/area/shuttle/caravan/pirate)
"jU" = (
/obj/structure/shuttle/engine/propulsion/burst{
	dir = 8
	},
/turf/open/floor/plating/airless,
/area/shuttle/caravan/pirate)
"kl" = (
/obj/machinery/atmospherics/pipe/manifold/supply/hidden{
	dir = 1
	},
/turf/open/floor/plasteel/white/side{
	dir = 1
	},
/area/shuttle/caravan/pirate)
"ku" = (
/obj/structure/rack,
/obj/item/storage/bag/money/vault,
/obj/effect/turf_decal/tile/blue{
	dir = 4
	},
/mob/living/simple_animal/parrot{
	faction = list("pirate");
	name = "Pegwing"
	},
/turf/open/floor/plasteel/dark,
/area/shuttle/caravan/pirate)
"kY" = (
/obj/machinery/atmospherics/pipe/manifold/supply/hidden{
	dir = 8
	},
/obj/machinery/meter,
/turf/open/floor/plating,
/area/shuttle/caravan/pirate)
"le" = (
/obj/machinery/porta_turret/syndicate/pod{
	dir = 5;
	faction = list("pirate")
	},
/turf/closed/wall/mineral/plastitanium,
/area/shuttle/caravan/pirate)
"lG" = (
/obj/machinery/atmospherics/components/unary/vent_pump/on,
/obj/effect/turf_decal/tile/neutral{
	dir = 1
	},
/obj/effect/turf_decal/tile/neutral,
/obj/effect/turf_decal/tile/neutral{
	dir = 4
	},
/obj/effect/turf_decal/tile/neutral{
	dir = 8
	},
/turf/open/floor/plasteel/dark,
/area/shuttle/caravan/pirate)
"mr" = (
/obj/machinery/atmospherics/pipe/simple/supply/hidden{
	dir = 4
	},
/obj/machinery/door/firedoor,
/obj/machinery/door/airlock/command{
	name = "Bridge"
	},
/obj/effect/turf_decal/tile/neutral{
	dir = 1
	},
/obj/effect/turf_decal/tile/neutral,
/obj/effect/turf_decal/tile/neutral{
	dir = 4
	},
/obj/effect/turf_decal/tile/neutral{
	dir = 8
	},
/turf/open/floor/plasteel/dark,
/area/shuttle/caravan/pirate)
"mI" = (
/obj/structure/table,
/obj/item/storage/firstaid/brute{
	pixel_x = 3;
	pixel_y = 3
	},
/obj/item/storage/firstaid/fire,
/obj/machinery/firealarm{
	dir = 1;
	pixel_y = -24
	},
/turf/open/floor/plasteel/white,
/area/shuttle/caravan/pirate)
"na" = (
/obj/machinery/atmospherics/pipe/simple/supply/hidden{
	dir = 4
	},
/turf/open/floor/plasteel/white/side{
	dir = 1
	},
/area/shuttle/caravan/pirate)
"nD" = (
/obj/machinery/light/small{
	dir = 4
	},
/obj/machinery/atmospherics/pipe/simple/supply/hidden{
	dir = 10
	},
/turf/open/floor/plasteel/white/side{
	dir = 1
	},
/area/shuttle/caravan/pirate)
"oe" = (
/obj/structure/table,
/obj/item/circular_saw,
/obj/item/scalpel{
	pixel_y = 12
	},
/obj/item/cautery{
	pixel_x = 4
	},
/obj/machinery/light/small{
	dir = 8
	},
/turf/open/floor/plasteel/white/side{
	dir = 8
	},
/area/shuttle/caravan/pirate)
"oF" = (
/obj/structure/closet{
	name = "pirate outfits"
	},
/obj/item/clothing/head/collectable/pirate,
/obj/item/clothing/suit/pirate,
/obj/item/clothing/under/costume/pirate,
/obj/item/clothing/shoes/jackboots,
/obj/item/clothing/head/bandana,
/obj/effect/turf_decal/tile/red{
	dir = 1
	},
/turf/open/floor/plasteel/dark,
/area/shuttle/caravan/pirate)
"oL" = (
/turf/closed/wall/mineral/plastitanium,
/area/shuttle/caravan/pirate)
"oO" = (
/obj/machinery/computer/camera_advanced/shuttle_docker/caravan/pirate,
/obj/effect/turf_decal/tile/red{
	dir = 1
	},
/obj/effect/turf_decal/tile/red{
	dir = 4
	},
/turf/open/floor/plasteel/dark,
/area/shuttle/caravan/pirate)
"oT" = (
/obj/structure/table,
/obj/structure/window/reinforced{
	dir = 8
	},
/obj/machinery/door/window/southleft{
	name = "Weapon Storage"
	},
/obj/item/grenade/smokebomb{
	pixel_x = -4
	},
/obj/item/grenade/smokebomb{
	pixel_x = 2
	},
/obj/effect/turf_decal/tile/neutral{
	dir = 1
	},
/obj/effect/turf_decal/tile/neutral,
/obj/effect/turf_decal/tile/neutral{
	dir = 4
	},
/obj/effect/turf_decal/tile/neutral{
	dir = 8
	},
/turf/open/floor/plasteel/dark,
/area/shuttle/caravan/pirate)
"pK" = (
/obj/item/stack/sheet/mineral/gold{
	amount = 25
	},
/obj/item/stack/sheet/mineral/bananium{
	amount = 5
	},
/obj/item/stack/sheet/mineral/silver{
	amount = 25
	},
/obj/item/stack/sheet/mineral/uranium{
	amount = 10
	},
/obj/item/stack/sheet/mineral/diamond{
	amount = 5
	},
/obj/structure/closet/crate,
/obj/item/coin/silver,
/obj/item/coin/silver,
/obj/item/coin/silver,
/obj/item/coin/gold,
/obj/item/coin/gold,
/obj/effect/turf_decal/tile/blue,
/turf/open/floor/plasteel/dark,
/area/shuttle/caravan/pirate)
"pS" = (
/obj/machinery/atmospherics/components/unary/vent_pump/on,
/obj/effect/decal/cleanable/dirt,
/turf/open/floor/plasteel,
/area/shuttle/caravan/pirate)
"pZ" = (
/obj/structure/tank_dispenser/oxygen,
/obj/machinery/firealarm{
	pixel_y = 24
	},
/obj/effect/turf_decal/tile/neutral{
	dir = 1
	},
/obj/effect/turf_decal/tile/neutral,
/obj/effect/turf_decal/tile/neutral{
	dir = 4
	},
/obj/effect/turf_decal/tile/neutral{
	dir = 8
	},
/turf/open/floor/plasteel/dark,
/area/shuttle/caravan/pirate)
"qo" = (
/obj/machinery/porta_turret/syndicate/pod{
	dir = 6;
	faction = list("pirate")
	},
/turf/closed/wall/mineral/plastitanium,
/area/shuttle/caravan/pirate)
"qC" = (
/obj/structure/table,
/obj/item/storage/fancy/donut_box{
	pixel_y = 18
	},
/obj/item/storage/box/donkpockets{
	pixel_x = -3;
	pixel_y = 7
	},
/obj/item/storage/box/donkpockets{
	pixel_x = -6
	},
/obj/item/reagent_containers/food/drinks/bottle/rum{
	pixel_x = 8;
	pixel_y = 3
	},
/obj/structure/sign/poster/contraband/red_rum{
	pixel_x = 32
	},
/turf/open/floor/plasteel/dark,
/area/shuttle/caravan/pirate)
"qX" = (
/obj/structure/reagent_dispensers/watertank,
/obj/item/reagent_containers/glass/bucket,
/obj/item/mop,
/obj/effect/turf_decal/stripes/line{
	dir = 5
	},
/turf/open/floor/plating,
/area/shuttle/caravan/pirate)
"sr" = (
/obj/machinery/atmospherics/pipe/simple/supply/hidden{
	dir = 4
	},
/obj/effect/turf_decal/tile/red,
/obj/effect/turf_decal/tile/red{
	dir = 8
	},
/turf/open/floor/plasteel,
/area/shuttle/caravan/pirate)
"su" = (
/obj/effect/decal/cleanable/dirt,
/turf/open/floor/plasteel,
/area/shuttle/caravan/pirate)
"th" = (
/obj/machinery/atmospherics/pipe/simple/supply/hidden{
	dir = 4
	},
/obj/machinery/door/firedoor,
/obj/machinery/door/airlock/engineering{
	name = "Engineering"
	},
/turf/open/floor/plating,
/area/shuttle/caravan/pirate)
"to" = (
/obj/structure/table,
/obj/item/reagent_containers/food/drinks/bottle/rum{
	pixel_x = 3;
	pixel_y = 6
	},
/obj/item/reagent_containers/food/drinks/bottle/rum,
/turf/open/floor/plasteel/dark,
/area/shuttle/caravan/pirate)
"tM" = (
/obj/effect/decal/cleanable/dirt,
/mob/living/simple_animal/hostile/pirate/ranged{
	environment_smash = 0
	},
/turf/open/floor/plasteel,
/area/shuttle/caravan/pirate)
"ul" = (
/obj/structure/table,
/obj/item/retractor,
/obj/item/hemostat,
/turf/open/floor/plasteel/white,
/area/shuttle/caravan/pirate)
"un" = (
/obj/machinery/atmospherics/pipe/simple/supply/hidden{
	dir = 4
	},
/obj/effect/turf_decal/tile/red{
	dir = 1
	},
/obj/effect/turf_decal/tile/red,
/obj/effect/turf_decal/tile/red{
	dir = 8
	},
/turf/open/floor/plasteel,
/area/shuttle/caravan/pirate)
"vd" = (
/obj/machinery/atmospherics/pipe/simple/supply/hidden{
	dir = 6
	},
/obj/effect/decal/cleanable/dirt,
/turf/open/floor/plasteel,
/area/shuttle/caravan/pirate)
"vq" = (
/obj/structure/bed,
/obj/item/bedsheet/brown,
/obj/machinery/firealarm{
	dir = 8;
	pixel_x = -26
	},
/turf/open/floor/plasteel/dark/side{
	dir = 6
	},
/area/shuttle/caravan/pirate)
"vW" = (
/obj/machinery/light/small{
	dir = 4
	},
/obj/machinery/atmospherics/pipe/simple/supply/hidden,
/turf/open/floor/plating,
/area/shuttle/caravan/pirate)
"wL" = (
/obj/machinery/button/door{
	id = "caravanpirate_bolt_port";
	name = "External Bolt Control";
	normaldoorcontrol = 1;
	pixel_x = -4;
	pixel_y = 25;
	specialfunctions = 4
	},
/obj/machinery/atmospherics/pipe/simple/supply/hidden{
	dir = 4
	},
/turf/open/floor/plasteel/white/side{
	dir = 1
	},
/area/shuttle/caravan/pirate)
"wX" = (
/obj/machinery/light/small{
	dir = 8
	},
/obj/effect/turf_decal/tile/red{
	dir = 1
	},
/obj/effect/turf_decal/tile/red{
	dir = 8
	},
/turf/open/floor/plasteel,
/area/shuttle/caravan/pirate)
"wZ" = (
/obj/machinery/atmospherics/pipe/manifold/supply/hidden{
	dir = 4
	},
/obj/effect/turf_decal/tile/neutral{
	dir = 1
	},
/obj/effect/turf_decal/tile/neutral,
/obj/effect/turf_decal/tile/neutral{
	dir = 4
	},
/obj/effect/turf_decal/tile/neutral{
	dir = 8
	},
/turf/open/floor/plasteel/dark,
/area/shuttle/caravan/pirate)
"xg" = (
/obj/structure/table,
/obj/machinery/microwave{
	pixel_y = 5
	},
/turf/open/floor/plasteel/dark,
/area/shuttle/caravan/pirate)
"yt" = (
/obj/structure/reagent_dispensers/fueltank,
/obj/effect/turf_decal/stripes/line{
	dir = 4
	},
/turf/open/floor/plating,
/area/shuttle/caravan/pirate)
"yu" = (
/obj/machinery/atmospherics/pipe/simple/supply/hidden{
	dir = 10
	},
/obj/effect/turf_decal/tile/neutral{
	dir = 1
	},
/obj/effect/turf_decal/tile/neutral,
/obj/effect/turf_decal/tile/neutral{
	dir = 4
	},
/obj/effect/turf_decal/tile/neutral{
	dir = 8
	},
/turf/open/floor/plasteel/dark,
/area/shuttle/caravan/pirate)
"yW" = (
/obj/machinery/atmospherics/components/unary/vent_pump/on{
	dir = 4
	},
/obj/machinery/space_heater,
/obj/effect/turf_decal/stripes/line{
	dir = 6
	},
/turf/open/floor/plating,
/area/shuttle/caravan/pirate)
"zB" = (
/obj/machinery/button/door{
	id = "caravanpirate_bolt_starboard";
	name = "External Bolt Control";
	normaldoorcontrol = 1;
	pixel_x = -4;
	pixel_y = -25;
	specialfunctions = 4
	},
/obj/machinery/atmospherics/pipe/simple/supply/hidden{
	dir = 4
	},
/obj/effect/turf_decal/tile/red,
/obj/effect/turf_decal/tile/red{
	dir = 8
	},
/turf/open/floor/plasteel,
/area/shuttle/caravan/pirate)
"Ag" = (
/obj/structure/table/optable,
/obj/effect/turf_decal/bot,
/turf/open/floor/plasteel/white,
/area/shuttle/caravan/pirate)
"Ah" = (
/obj/effect/mapping_helpers/airlock/cyclelink_helper{
	dir = 1
	},
/obj/effect/mapping_helpers/airlock/locked,
/obj/machinery/door/airlock/external{
	id_tag = "caravanpirate_bolt_starboard"
	},
/turf/open/floor/plating,
/area/shuttle/caravan/pirate)
"Av" = (
/obj/machinery/atmospherics/pipe/simple/supply/hidden{
	dir = 4
	},
/obj/machinery/door/firedoor,
/obj/machinery/door/airlock/medical/glass{
	name = "Medbay"
	},
/obj/effect/decal/cleanable/dirt,
/turf/open/floor/plasteel,
/area/shuttle/caravan/pirate)
"AP" = (
/obj/structure/sign/departments/medbay/alt,
/turf/closed/wall/mineral/plastitanium/nodiagonal,
/area/shuttle/caravan/pirate)
"Bi" = (
/obj/structure/grille,
/obj/structure/window/plasma/reinforced/plastitanium,
/obj/machinery/door/poddoor{
	id = "caravanpirate_bridge"
	},
/turf/open/floor/plating,
/area/shuttle/caravan/pirate)
"BI" = (
/obj/structure/table,
/obj/machinery/light/small{
	brightness = 3;
	dir = 8
	},
/obj/item/stack/spacecash/c200,
/turf/open/floor/plasteel/dark,
/area/shuttle/caravan/pirate)
"BL" = (
/obj/structure/table,
/obj/machinery/cell_charger,
/obj/item/stack/cable_coil,
/obj/item/stock_parts/cell/high,
/obj/effect/turf_decal/bot,
/turf/open/floor/plating,
/area/shuttle/caravan/pirate)
"Cb" = (
/obj/machinery/power/apc{
	dir = 8;
	name = "Pirate Cutter APC";
	pixel_x = -25
	},
/obj/machinery/atmospherics/pipe/simple/supply/hidden,
/obj/machinery/airalarm/all_access{
	dir = 8;
	pixel_x = 24
	},
/obj/structure/cable,
/turf/open/floor/plating,
/area/shuttle/caravan/pirate)
"DY" = (
/obj/structure/closet/crate/secure/loot,
/obj/machinery/airalarm/all_access{
	pixel_y = 24
	},
/turf/open/floor/plasteel/dark,
/area/shuttle/caravan/pirate)
"EB" = (
/obj/structure/chair/office{
	dir = 4
	},
/obj/machinery/turretid{
	icon_state = "control_kill";
	lethal = 1;
	locked = 0;
	pixel_y = -30;
	req_access = null
	},
/obj/effect/turf_decal/tile/neutral{
	dir = 1
	},
/obj/effect/turf_decal/tile/neutral,
/obj/effect/turf_decal/tile/neutral{
	dir = 4
	},
/obj/effect/turf_decal/tile/neutral{
	dir = 8
	},
/mob/living/simple_animal/hostile/pirate/ranged{
	environment_smash = 0
	},
/turf/open/floor/plasteel/dark,
/area/shuttle/caravan/pirate)
"EK" = (
/obj/machinery/atmospherics/components/unary/vent_pump/on{
	dir = 1
	},
/turf/open/floor/plasteel,
/area/shuttle/caravan/pirate)
"FM" = (
/obj/machinery/power/terminal{
	dir = 1
	},
/obj/structure/closet/crate,
/obj/item/stack/sheet/metal/twenty,
/obj/item/stack/sheet/glass{
	amount = 10
	},
/obj/item/storage/toolbox/mechanical,
/obj/item/flashlight{
	pixel_x = 3;
	pixel_y = 3
	},
/obj/item/stack/sheet/mineral/plasma{
	amount = 20
	},
/obj/effect/turf_decal/stripes/line{
	dir = 4
	},
/obj/structure/cable,
/turf/open/floor/plating,
/area/shuttle/caravan/pirate)
"Gh" = (
/obj/machinery/atmospherics/components/unary/tank/air,
/obj/effect/turf_decal/bot,
/turf/open/floor/plating,
/area/shuttle/caravan/pirate)
"GQ" = (
/obj/machinery/light/small{
	dir = 4
	},
/obj/machinery/atmospherics/pipe/simple/supply/hidden{
	dir = 9
	},
/obj/effect/turf_decal/tile/red,
/obj/effect/turf_decal/tile/red{
	dir = 8
	},
/turf/open/floor/plasteel,
/area/shuttle/caravan/pirate)
"GR" = (
/obj/structure/table,
/obj/item/coin/gold,
/obj/item/coin/silver,
/obj/item/coin/silver,
/turf/open/floor/plasteel/dark,
/area/shuttle/caravan/pirate)
"HD" = (
/obj/structure/shuttle/engine/heater{
	dir = 8
	},
/obj/structure/window/reinforced{
	dir = 4
	},
/turf/open/floor/plating/airless,
/area/shuttle/caravan/pirate)
"HO" = (
/obj/machinery/atmospherics/pipe/simple/supply/hidden{
	dir = 4
	},
/obj/machinery/door/firedoor,
/obj/machinery/door/airlock/security{
	name = "Armory"
	},
/obj/effect/decal/cleanable/dirt,
/turf/open/floor/plasteel,
/area/shuttle/caravan/pirate)
"II" = (
/obj/structure/closet/crate/freezer/surplus_limbs,
/obj/effect/turf_decal/bot,
/turf/open/floor/plasteel/white,
/area/shuttle/caravan/pirate)
"Jb" = (
/obj/effect/mapping_helpers/airlock/cyclelink_helper,
/obj/effect/mapping_helpers/airlock/locked,
/obj/machinery/door/airlock/external{
	id_tag = "caravanpirate_bolt_port"
	},
/obj/docking_port/mobile{
	callTime = 150;
	dir = 2;
	dwidth = 14;
	height = 13;
	id = "caravanpirate";
	movement_force = list("KNOCKDOWN" = 0, "THROW" = 0);
	name = "Pirate Cutter";
	port_direction = 8;
	preferred_direction = 4;
	width = 22
	},
/turf/open/floor/plating,
/area/shuttle/caravan/pirate)
"Jv" = (
/turf/template_noop,
/area/template_noop)
"Kd" = (
/obj/machinery/sleeper{
	dir = 1
	},
/obj/effect/turf_decal/delivery,
/obj/machinery/airalarm/all_access{
	dir = 1;
	pixel_y = -24
	},
/turf/open/floor/plasteel/white,
/area/shuttle/caravan/pirate)
"Ku" = (
/obj/effect/mapping_helpers/airlock/cyclelink_helper,
/obj/effect/mapping_helpers/airlock/locked,
/obj/machinery/door/airlock/external{
	id_tag = "caravanpirate_bolt_starboard"
	},
/turf/open/floor/plating,
/area/shuttle/caravan/pirate)
"Ld" = (
/obj/machinery/suit_storage_unit/open,
/obj/effect/turf_decal/tile/neutral{
	dir = 1
	},
/obj/effect/turf_decal/tile/neutral,
/obj/effect/turf_decal/tile/neutral{
	dir = 4
	},
/obj/effect/turf_decal/tile/neutral{
	dir = 8
	},
/turf/open/floor/plasteel/dark,
/area/shuttle/caravan/pirate)
"Nx" = (
/obj/structure/shuttle/engine/propulsion/burst/right{
	dir = 8
	},
/turf/open/floor/plating/airless,
/area/shuttle/caravan/pirate)
"NM" = (
/obj/machinery/light/small{
	dir = 8
	},
/obj/structure/closet/crate/secure/loot,
/obj/machinery/atmospherics/components/unary/vent_pump/on{
	dir = 4
	},
/obj/structure/extinguisher_cabinet{
	pixel_x = -27
	},
/turf/open/floor/plasteel/dark,
/area/shuttle/caravan/pirate)
"Pc" = (
/obj/structure/sign/departments/engineering,
/turf/closed/wall/mineral/plastitanium/nodiagonal,
/area/shuttle/caravan/pirate)
"Pn" = (
/obj/structure/shuttle/engine/propulsion/burst/left{
	dir = 8
	},
/turf/open/floor/plating/airless,
/area/shuttle/caravan/pirate)
"Rq" = (
/obj/machinery/atmospherics/pipe/simple/supply/hidden{
	dir = 4
	},
/turf/open/floor/plasteel/white/side{
	dir = 9
	},
/area/shuttle/caravan/pirate)
"Rz" = (
/obj/effect/mapping_helpers/airlock/cyclelink_helper{
	dir = 1
	},
/obj/effect/mapping_helpers/airlock/locked,
/obj/machinery/door/airlock/external{
	id_tag = "caravanpirate_bolt_port"
	},
/turf/open/floor/plating,
/area/shuttle/caravan/pirate)
"RC" = (
/obj/machinery/atmospherics/pipe/simple/supply/hidden{
	dir = 4
	},
/obj/effect/turf_decal/tile/red{
	dir = 1
	},
/obj/effect/turf_decal/tile/red{
	dir = 8
	},
/turf/open/floor/plasteel/dark,
/area/shuttle/caravan/pirate)
"RK" = (
/obj/machinery/power/smes{
	charge = 5e+006
	},
/obj/effect/turf_decal/stripes/line{
	dir = 5
	},
/obj/structure/cable,
/turf/open/floor/plating,
/area/shuttle/caravan/pirate)
"Sd" = (
/obj/machinery/light/small{
	dir = 8
	},
/obj/structure/sign/warning/vacuum{
	pixel_x = -32
	},
/turf/open/floor/plating,
/area/shuttle/caravan/pirate)
"Sk" = (
/obj/machinery/atmospherics/pipe/simple/supply/hidden{
	dir = 4
	},
/obj/effect/turf_decal/tile/blue,
/obj/effect/turf_decal/tile/blue{
	dir = 4
	},
/turf/open/floor/plasteel/dark,
/area/shuttle/caravan/pirate)
"SF" = (
/obj/machinery/atmospherics/pipe/simple/supply/hidden{
	dir = 4
	},
/turf/open/floor/plasteel/dark/side{
	dir = 4
	},
/area/shuttle/caravan/pirate)
"SR" = (
/obj/machinery/atmospherics/pipe/simple/supply/hidden{
	dir = 9
	},
/obj/machinery/firealarm{
	dir = 1;
	pixel_y = -24
	},
/turf/open/floor/plasteel/dark,
/area/shuttle/caravan/pirate)
"UP" = (
/obj/structure/rack,
/obj/item/storage/toolbox/emergency,
/obj/item/weldingtool,
/obj/effect/turf_decal/tile/red{
	dir = 4
	},
/turf/open/floor/plasteel/dark,
/area/shuttle/caravan/pirate)
"Wb" = (
/obj/machinery/light/small,
/obj/structure/bed,
/obj/item/bedsheet/brown,
/turf/open/floor/plasteel/dark,
/area/shuttle/caravan/pirate)
"Xq" = (
/obj/structure/table/reinforced,
/obj/machinery/recharger,
/obj/item/melee/classic_baton,
/obj/effect/turf_decal/tile/red,
/turf/open/floor/plasteel/dark,
/area/shuttle/caravan/pirate)
"Yj" = (
/obj/machinery/porta_turret/syndicate/pod{
	dir = 9;
	faction = list("pirate")
	},
/turf/closed/wall/mineral/plastitanium,
/area/shuttle/caravan/pirate)
"Yo" = (
/obj/structure/table,
/obj/item/storage/box/lethalshot,
/obj/effect/turf_decal/tile/neutral{
	dir = 1
	},
/obj/effect/turf_decal/tile/neutral,
/obj/effect/turf_decal/tile/neutral{
	dir = 4
	},
/obj/effect/turf_decal/tile/neutral{
	dir = 8
	},
/turf/open/floor/plasteel/dark,
/area/shuttle/caravan/pirate)
"Yw" = (
/obj/machinery/atmospherics/pipe/simple/supply/hidden{
	dir = 4
	},
/turf/open/floor/plasteel/dark,
/area/shuttle/caravan/pirate)
"Zo" = (
/obj/machinery/atmospherics/pipe/simple/supply/hidden{
	dir = 5
	},
/turf/open/floor/plating,
/area/shuttle/caravan/pirate)
"ZY" = (
/obj/structure/chair/office{
	dir = 8
	},
/obj/effect/turf_decal/tile/neutral{
	dir = 1
	},
/obj/effect/turf_decal/tile/neutral,
/obj/effect/turf_decal/tile/neutral{
	dir = 4
	},
/obj/effect/turf_decal/tile/neutral{
	dir = 8
	},
/turf/open/floor/plasteel/dark,
/area/shuttle/caravan/pirate)

(1,1,1) = {"
Jv
Jv
Jv
Pn
jU
Nx
Jv
Pn
jU
Nx
Jv
Jv
Jv
"}
(2,1,1) = {"
Jv
Jv
oL
HD
HD
HD
af
HD
HD
HD
oL
Jv
Jv
"}
(3,1,1) = {"
Jv
Yj
af
qX
yt
yW
af
RK
FM
jh
af
eL
Jv
"}
(4,1,1) = {"
Jv
af
Gh
kY
vW
fh
Cb
hI
vW
Zo
BL
af
Jv
"}
(5,1,1) = {"
Jv
af
af
th
Pc
af
af
af
Pc
th
af
af
Jv
"}
(6,1,1) = {"
Jv
af
Ld
Rq
oe
ul
af
Yo
wX
un
Ld
af
Jv
"}
(7,1,1) = {"
oL
af
af
na
su
Ag
af
jo
tM
sr
af
af
oL
"}
(8,1,1) = {"
Jb
Sd
Rz
kl
EK
mI
af
pZ
pS
fU
Ku
Sd
Ah
"}
(9,1,1) = {"
oL
af
af
wL
su
Kd
af
oT
hh
zB
af
af
oL
"}
(10,1,1) = {"
Jv
Bi
Ld
nD
bH
II
af
iX
vd
GQ
Ld
Bi
Jv
"}
(11,1,1) = {"
Jv
oL
af
AP
Av
af
af
af
HO
af
af
oL
Jv
"}
(12,1,1) = {"
Jv
Jv
af
aE
SF
vq
NM
fS
RC
oF
af
Jv
Jv
"}
(13,1,1) = {"
Jv
Jv
af
hT
yu
hZ
wZ
de
iF
Wb
af
Jv
Jv
"}
(14,1,1) = {"
Jv
Jv
le
af
xg
qC
pK
Sk
ku
af
qo
Jv
Jv
"}
(15,1,1) = {"
Jv
Jv
Jv
oL
af
af
af
mr
af
oL
Jv
Jv
Jv
"}
(16,1,1) = {"
Jv
Jv
Jv
Jv
af
to
BI
Yw
af
Jv
Jv
Jv
Jv
"}
(17,1,1) = {"
Jv
Jv
Jv
Jv
af
GR
ZY
Yw
af
Jv
Jv
Jv
Jv
"}
(18,1,1) = {"
Jv
Jv
Jv
Jv
af
DY
lG
SR
af
Jv
Jv
Jv
Jv
"}
(19,1,1) = {"
Jv
Jv
Jv
Jv
af
UP
dE
Xq
af
Jv
Jv
Jv
Jv
"}
(20,1,1) = {"
Jv
Jv
Jv
Jv
Bi
oO
EB
bd
Bi
Jv
Jv
Jv
Jv
"}
(21,1,1) = {"
Jv
Jv
Jv
Jv
Bi
Bi
fL
Bi
Bi
Jv
Jv
Jv
Jv
"}
(22,1,1) = {"
Jv
Jv
Jv
Jv
Jv
Bi
Bi
Bi
Jv
Jv
Jv
Jv
Jv
"}
