//MAP CONVERTED BY dmm2tgm.py THIS HEADER COMMENT PREVENTS RECONVERSION, DO NOT REMOVE
"aa" = (
/turf/template_noop,
/area/template_noop)
"ab" = (
/turf/closed/wall/mineral/titanium,
/area/shuttle/abandoned)
"ac" = (
/obj/machinery/door/airlock/titanium{
	name = "mech bay external airlock"
	},
/obj/effect/decal/cleanable/dirt/dust,
/obj/docking_port/mobile{
	dir = 2;
	dwidth = 8;
	height = 16;
	id = "whiteship";
	launch_status = 0;
	name = "NT Recovery White-Ship";
	port_direction = 8;
	width = 16
	},
/turf/open/floor/plating,
/area/shuttle/abandoned)
"ad" = (
/obj/structure/shuttle/engine/propulsion{
	dir = 1
	},
/turf/open/floor/plating/airless,
/area/shuttle/abandoned)
"ae" = (
/obj/machinery/mech_bay_recharge_port{
	dir = 2
	},
/obj/effect/decal/cleanable/dirt/dust,
/turf/open/floor/mineral/titanium/yellow,
/area/shuttle/abandoned)
"af" = (
/obj/effect/decal/cleanable/dirt/dust,
/obj/machinery/light{
	dir = 1
	},
/turf/open/floor/mineral/titanium/yellow,
/area/shuttle/abandoned)
"ag" = (
/obj/effect/decal/cleanable/dirt/dust,
/turf/open/floor/mineral/titanium/yellow,
/area/shuttle/abandoned)
"ah" = (
/obj/effect/decal/cleanable/dirt/dust,
/turf/open/floor/mineral/titanium,
/area/shuttle/abandoned)
"ai" = (
/obj/effect/decal/cleanable/cobweb/cobweb2,
/obj/structure/frame/machine,
/obj/item/stack/cable_coil,
/obj/effect/decal/cleanable/dirt/dust,
/turf/open/floor/mineral/titanium/yellow,
/area/shuttle/abandoned)
"aj" = (
/obj/structure/shuttle/engine/heater{
	dir = 1
	},
/obj/structure/window/reinforced,
/turf/open/floor/plating/airless,
/area/shuttle/abandoned)
"ak" = (
/obj/structure/mecha_wreckage/ripley,
/obj/effect/decal/cleanable/dirt/dust,
/turf/open/floor/mech_bay_recharge_floor,
/area/shuttle/abandoned)
"al" = (
/obj/effect/decal/cleanable/dirt/dust,
/obj/effect/decal/cleanable/dirt/dust,
/turf/open/floor/mineral/titanium/yellow,
/area/shuttle/abandoned)
"am" = (
/obj/effect/decal/cleanable/dirt/dust,
/obj/effect/decal/cleanable/dirt/dust,
/obj/effect/decal/cleanable/dirt/dust,
/turf/open/floor/mineral/titanium,
/area/shuttle/abandoned)
"an" = (
/obj/effect/spawner/lootdrop/whiteship_cere_ripley,
/turf/open/floor/mech_bay_recharge_floor,
/area/shuttle/abandoned)
"ao" = (
/obj/machinery/computer/mech_bay_power_console{
	dir = 4
	},
/obj/effect/decal/cleanable/dirt/dust,
/turf/open/floor/mineral/titanium/yellow,
/area/shuttle/abandoned)
"ap" = (
/obj/machinery/computer/mech_bay_power_console{
	dir = 8
	},
/turf/open/floor/mineral/titanium/yellow,
/area/shuttle/abandoned)
"aq" = (
/obj/machinery/door/airlock/titanium{
	name = "mech bay"
	},
/turf/open/floor/mineral/titanium/yellow,
/area/shuttle/abandoned)
"ar" = (
/obj/effect/spawner/structure/window/shuttle,
/turf/open/floor/plating,
/area/shuttle/abandoned)
"as" = (
/obj/effect/turf_decal/delivery{
	dir = 1
	},
/obj/structure/closet/crate{
	name = "spare equipment crate"
	},
/obj/item/stack/sheet/metal/fifty,
/obj/item/stack/sheet/metal/fifty,
/obj/effect/decal/cleanable/cobweb,
/obj/effect/decal/cleanable/dirt/dust,
/obj/effect/decal/cleanable/dirt/dust,
/obj/effect/decal/cleanable/dirt/dust,
/turf/open/floor/mineral/titanium/yellow,
/area/shuttle/abandoned)
"at" = (
/obj/effect/turf_decal/delivery{
	dir = 1
	},
/obj/effect/decal/cleanable/dirt/dust,
/obj/effect/decal/cleanable/dirt/dust,
/obj/machinery/light{
	dir = 1
	},
/turf/open/floor/mineral/titanium/yellow,
/area/shuttle/abandoned)
"au" = (
/obj/effect/turf_decal/delivery{
	dir = 1
	},
/obj/effect/decal/cleanable/dirt/dust,
/turf/open/floor/mineral/titanium/yellow,
/area/shuttle/abandoned)
"av" = (
/obj/effect/turf_decal/delivery{
	dir = 1
	},
/obj/effect/decal/cleanable/dirt/dust,
/obj/structure/closet/crate{
	icon_state = "crateopen";
	name = "spare equipment crate"
	},
/turf/open/floor/mineral/titanium/yellow,
/area/shuttle/abandoned)
"aw" = (
/obj/effect/turf_decal/delivery{
	dir = 1
	},
/obj/effect/decal/cleanable/dirt/dust,
/obj/machinery/light{
	dir = 1
	},
/turf/open/floor/mineral/titanium/yellow,
/area/shuttle/abandoned)
"ax" = (
/obj/effect/turf_decal/delivery{
	dir = 1
	},
/obj/structure/closet/crate{
	icon_state = "crateopen";
	name = "spare equipment crate"
	},
/obj/item/pickaxe,
/obj/item/pickaxe,
/obj/item/storage/toolbox/emergency/old,
/obj/effect/decal/cleanable/dirt/dust,
/turf/open/floor/mineral/titanium/yellow,
/area/shuttle/abandoned)
"ay" = (
/turf/closed/wall/mineral/titanium/nodiagonal,
/area/shuttle/abandoned)
"az" = (
/obj/effect/turf_decal/delivery{
	dir = 1
	},
/obj/machinery/button/door{
	id = "cerewhiteleft";
	name = "Cargo Blast Door Toggle";
	pixel_x = -24
	},
/obj/effect/decal/cleanable/dirt/dust,
/turf/open/floor/mineral/titanium/yellow,
/area/shuttle/abandoned)
"aA" = (
/obj/effect/turf_decal/delivery{
	dir = 1
	},
/obj/effect/decal/cleanable/dirt/dust,
/obj/effect/decal/cleanable/dirt/dust,
/turf/open/floor/mineral/titanium/yellow,
/area/shuttle/abandoned)
"aB" = (
/obj/effect/turf_decal/delivery{
	dir = 1
	},
/obj/structure/closet/crate{
	icon_state = "crateopen";
	name = "spare equipment crate"
	},
/obj/item/storage/bag/ore,
/obj/item/pickaxe,
/obj/effect/decal/cleanable/dirt/dust,
/turf/open/floor/mineral/titanium/yellow,
/area/shuttle/abandoned)
"aC" = (
/obj/effect/turf_decal/delivery{
	dir = 1
	},
/obj/effect/decal/cleanable/dirt/dust,
/obj/effect/decal/cleanable/dirt/dust,
/obj/effect/decal/cleanable/dirt/dust,
/turf/open/floor/mineral/titanium/yellow,
/area/shuttle/abandoned)
"aD" = (
/obj/effect/turf_decal/delivery{
	dir = 1
	},
/obj/structure/closet/crate{
	name = "spare equipment crate"
	},
/obj/item/stack/sheet/glass/fifty,
/obj/effect/decal/cleanable/dirt/dust,
/obj/effect/decal/cleanable/dirt/dust,
/obj/effect/decal/cleanable/dirt/dust,
/turf/open/floor/mineral/titanium/yellow,
/area/shuttle/abandoned)
"aE" = (
/obj/effect/turf_decal/delivery{
	dir = 1
	},
/obj/machinery/button/door{
	id = "cerewhiteright";
	name = "Cargo Blast Door Toggle";
	pixel_x = 24
	},
/obj/effect/decal/cleanable/dirt/dust,
/turf/open/floor/mineral/titanium/yellow,
/area/shuttle/abandoned)
"aF" = (
/obj/machinery/door/poddoor{
	id = "cerewhiteleft"
	},
/turf/open/floor/plating,
/area/shuttle/abandoned)
"aG" = (
/obj/effect/decal/cleanable/dirt/dust,
/obj/effect/decal/cleanable/dirt/dust,
/turf/open/floor/mineral/titanium,
/area/shuttle/abandoned)
"aH" = (
/obj/machinery/door/poddoor{
	id = "cerewhiteright"
	},
/turf/open/floor/plating,
/area/shuttle/abandoned)
"aI" = (
/obj/effect/turf_decal/delivery{
	dir = 1
	},
/obj/structure/closet/crate{
	name = "spare equipment crate"
	},
/obj/item/storage/toolbox/mechanical/old,
/obj/effect/decal/cleanable/dirt/dust,
/obj/effect/decal/cleanable/dirt/dust,
/obj/item/clothing/glasses/welding,
/turf/open/floor/mineral/titanium/yellow,
/area/shuttle/abandoned)
"aJ" = (
/obj/effect/turf_decal/delivery{
	dir = 1
	},
/obj/effect/decal/cleanable/dirt/dust,
/obj/effect/decal/cleanable/dirt/dust,
/obj/structure/closet/crate{
	icon_state = "crateopen";
	name = "spare equipment crate"
	},
/obj/machinery/light,
/turf/open/floor/mineral/titanium/yellow,
/area/shuttle/abandoned)
"aK" = (
/obj/effect/decal/cleanable/dirt/dust,
/obj/effect/decal/cleanable/dirt/dust,
/obj/effect/decal/cleanable/dirt/dust,
/obj/effect/decal/cleanable/dirt/dust,
/turf/open/floor/mineral/titanium,
/area/shuttle/abandoned)
"aL" = (
/obj/effect/turf_decal/delivery{
	dir = 1
	},
/obj/effect/decal/cleanable/dirt/dust,
/obj/effect/decal/cleanable/dirt/dust,
/obj/machinery/light,
/turf/open/floor/mineral/titanium/yellow,
/area/shuttle/abandoned)
"aM" = (
/obj/structure/ore_box,
/obj/effect/decal/cleanable/dirt/dust,
/turf/open/floor/mineral/titanium/yellow,
/area/shuttle/abandoned)
"aN" = (
/obj/machinery/door/airlock/titanium{
	name = "cockpit"
	},
/obj/effect/decal/cleanable/dirt/dust,
/turf/open/floor/mineral/titanium/blue,
/area/shuttle/abandoned)
"aO" = (
/obj/effect/decal/cleanable/dirt/dust,
/obj/structure/tank_dispenser/oxygen{
	layer = 2.7;
	pixel_x = -1;
	pixel_y = 2
	},
/turf/open/floor/mineral/titanium/yellow,
/area/shuttle/abandoned)
"aP" = (
/obj/structure/table,
/obj/item/gps{
	gpstag = "NTCONST1";
	pixel_x = -1;
	pixel_y = 2
	},
/obj/effect/decal/cleanable/dirt/dust,
/obj/machinery/light{
	dir = 1
	},
/turf/open/floor/mineral/titanium/blue,
/area/shuttle/abandoned)
"aQ" = (
/obj/effect/decal/cleanable/dirt/dust,
/obj/effect/decal/cleanable/dirt/dust,
/obj/effect/decal/cleanable/dirt/dust,
/turf/open/floor/mineral/titanium/blue,
/area/shuttle/abandoned)
"aR" = (
/obj/effect/decal/cleanable/dirt/dust,
/obj/effect/decal/cleanable/dirt/dust,
/turf/open/floor/mineral/titanium/blue,
/area/shuttle/abandoned)
"aS" = (
/obj/effect/decal/cleanable/dirt/dust,
/turf/open/floor/mineral/titanium/blue,
/area/shuttle/abandoned)
"aT" = (
/obj/structure/table,
/obj/effect/decal/cleanable/cobweb/cobweb2,
/obj/item/storage/firstaid/regular,
/obj/effect/decal/cleanable/dirt/dust,
/obj/machinery/light{
	dir = 1
	},
/turf/open/floor/mineral/titanium/blue,
/area/shuttle/abandoned)
"aU" = (
/obj/structure/table,
/obj/effect/decal/cleanable/dirt/dust,
/turf/open/floor/mineral/titanium/blue,
/area/shuttle/abandoned)
"aV" = (
/obj/machinery/suit_storage_unit/standard_unit,
/obj/effect/decal/cleanable/dirt/dust,
/turf/open/floor/mineral/titanium/blue,
/area/shuttle/abandoned)
"aW" = (
/obj/structure/chair/comfy/black,
/obj/effect/decal/cleanable/dirt/dust,
/obj/effect/decal/cleanable/dirt/dust,
/obj/effect/decal/cleanable/dirt/dust,
/turf/open/floor/mineral/titanium/blue,
/area/shuttle/abandoned)
"aX" = (
/obj/structure/closet/emcloset,
/obj/effect/decal/cleanable/dirt/dust,
/turf/open/floor/mineral/titanium/blue,
/area/shuttle/abandoned)
"aZ" = (
/obj/structure/table,
/obj/item/phone{
	pixel_x = -3;
	pixel_y = 3
	},
/obj/effect/decal/cleanable/dirt/dust,
/turf/open/floor/mineral/titanium/blue,
/area/shuttle/abandoned)
"ba" = (
/obj/machinery/computer/shuttle/white_ship{
	dir = 1
	},
/obj/effect/decal/cleanable/dirt/dust,
/turf/open/floor/mineral/titanium/blue,
/area/shuttle/abandoned)
"bb" = (
/obj/structure/table,
/obj/item/paper_bin{
	pixel_x = -1;
	pixel_y = 6
	},
/obj/effect/decal/cleanable/dirt/dust,
/turf/open/floor/mineral/titanium/blue,
/area/shuttle/abandoned)

(1,1,1) = {"
aa
aa
aa
aa
ad
aj
ay
aF
aF
ay
aa
aa
aa
aa
aa
aa
"}
(2,1,1) = {"
aa
ad
aj
ab
ab
ab
ay
ah
ah
ay
ab
ab
ab
aa
aa
aa
"}
(3,1,1) = {"
ab
ab
ab
ab
ab
ab
az
aG
aG
aI
aM
ab
ab
ab
ab
aa
"}
(4,1,1) = {"
ab
ae
ak
ao
ab
as
aA
am
ah
aA
ab
ab
ab
aV
ab
aa
"}
(5,1,1) = {"
ab
af
ag
ag
ab
at
aA
am
aG
aJ
ab
aP
aU
aS
ab
ab
"}
(6,1,1) = {"
ab
ag
al
al
aq
au
aB
am
aG
aK
aN
aQ
aR
aQ
aZ
ar
"}
(7,1,1) = {"
ac
ah
am
am
ar
ah
ah
am
aG
aG
ar
aR
aQ
aW
ba
ar
"}
(8,1,1) = {"
ab
ag
ag
ag
aq
av
au
aG
aG
aG
aN
aS
aS
aR
bb
ar
"}
(9,1,1) = {"
ab
af
ag
ag
ab
aw
aC
am
am
aL
ab
aT
aU
aR
ab
ab
"}
(10,1,1) = {"
ab
ai
an
ap
ab
ax
aD
am
am
av
ab
ab
ab
aX
ab
aa
"}
(11,1,1) = {"
ab
ab
ab
ab
ab
ab
aE
am
aG
au
aO
ab
ab
ab
ab
aa
"}
(12,1,1) = {"
aa
ad
aj
ab
ab
ab
ay
aG
ah
ay
ab
ab
ab
aa
aa
aa
"}
(13,1,1) = {"
aa
aa
aa
aa
ad
aj
ay
aH
aH
ay
aa
aa
aa
aa
aa
aa
"}
