//MAP CONVERTED BY dmm2tgm.py THIS HEADER COMMENT PREVENTS RECONVERSION, DO NOT REMOVE
"a" = (
/turf/template_noop,
/area/template_noop)
"b" = (
/turf/closed/indestructible/oldshuttle/corner{
	dir = 8
	},
/area/ruin/powered/shuttle/medium_4)
"c" = (
/turf/closed/indestructible/oldshuttle,
/area/ruin/powered/shuttle/medium_4)
"d" = (
/obj/machinery/door/airlock/public/glass,
/turf/open/floor/oldshuttle,
/area/ruin/powered/shuttle/medium_4)
"e" = (
/turf/closed/indestructible/oldshuttle/corner,
/area/ruin/powered/shuttle/medium_4)
"f" = (
/turf/closed/indestructible/oldshuttle/corner{
	dir = 1
	},
/area/ruin/powered/shuttle/medium_4)
"g" = (
/turf/open/floor/oldshuttle,
/area/ruin/powered/shuttle/medium_4)
"h" = (
/turf/closed/indestructible/oldshuttle/corner{
	dir = 4
	},
/area/ruin/powered/shuttle/medium_4)
"i" = (
/obj/structure/closet{
	icon_state = "oldcloset"
	},
/turf/open/floor/oldshuttle,
/area/ruin/powered/shuttle/medium_4)
"j" = (
/obj/structure/shuttle/engine/propulsion/burst{
	dir = 1
	},
/turf/open/space,
/area/ruin/powered/shuttle/medium_4)
"k" = (
/turf/closed/indestructible/oldshuttle{
	icon_state = "orange"
	},
/area/ruin/powered/shuttle/medium_4)
"l" = (
/obj/structure/chair/old{
	dir = 1
	},
/turf/open/floor/oldshuttle,
/area/ruin/powered/shuttle/medium_4)
"r" = (
/obj/machinery/power/generator,
/turf/open/floor/oldshuttle,
/area/ruin/powered/shuttle/medium_4)
"s" = (
/obj/machinery/power/smes,
/turf/open/floor/oldshuttle,
/area/ruin/powered/shuttle/medium_4)
"t" = (
/obj/structure/shuttle/engine/propulsion/burst/left,
/turf/open/space,
/area/ruin/powered/shuttle/medium_4)
"u" = (
/obj/structure/shuttle/engine/propulsion/burst/right,
/turf/open/space,
/area/ruin/powered/shuttle/medium_4)
"v" = (
/obj/structure/shuttle/engine/propulsion/burst/right,
/turf/open/floor/plating/asteroid/basalt/lava_land_surface,
/area/ruin/powered/shuttle/medium_4)
"w" = (
/obj/structure/shuttle/engine/propulsion/burst,
/turf/open/space,
/area/ruin/powered/shuttle/medium_4)

(1,1,1) = {"
a
a
a
a
a
a
a
a
a
a
b
c
k
t
a
"}
(2,1,1) = {"
a
a
a
a
a
a
a
b
c
c
f
g
k
k
w
"}
(3,1,1) = {"
a
a
a
a
a
b
d
f
g
g
g
g
k
k
w
"}
(4,1,1) = {"
a
a
a
a
j
k
g
g
g
g
b
d
k
u
a
"}
(5,1,1) = {"
a
a
a
a
b
c
g
g
g
b
f
a
a
a
a
"}
(6,1,1) = {"
a
a
b
c
c
c
c
c
c
c
c
c
c
h
a
"}
(7,1,1) = {"
a
b
f
i
c
i
i
i
i
i
i
c
s
c
h
"}
(8,1,1) = {"
b
f
i
i
c
l
l
l
l
l
l
c
g
e
c
"}
(9,1,1) = {"
c
g
g
g
g
l
l
l
l
l
b
c
g
g
c
"}
(10,1,1) = {"
d
g
g
g
g
g
g
g
g
g
c
r
g
g
d
"}
(11,1,1) = {"
c
g
g
g
g
l
l
l
l
l
e
c
g
g
c
"}
(12,1,1) = {"
e
h
i
i
c
l
l
l
l
l
l
c
g
b
c
"}
(13,1,1) = {"
a
e
h
i
c
i
i
i
i
i
i
c
s
c
f
"}
(14,1,1) = {"
a
a
e
c
c
c
c
c
c
c
c
c
c
f
a
"}
(15,1,1) = {"
a
a
a
a
e
c
g
g
g
e
h
a
a
a
a
"}
(16,1,1) = {"
a
a
a
a
j
k
g
g
g
g
e
d
k
t
a
"}
(17,1,1) = {"
a
a
a
a
a
e
d
h
g
g
g
g
k
k
w
"}
(18,1,1) = {"
a
a
a
a
a
a
a
e
c
c
h
g
k
k
w
"}
(19,1,1) = {"
a
a
a
a
a
a
a
a
a
a
e
c
k
v
a
"}
